PODet_ID,PO_ID,Det_Desc,Quantity,UnitPrice,GrossAmt,TaxAmt,TotalAmt
202,1,"Plumber Service",10,44,440,44,484
203,1,"Plumber Service",7,42,294,29,323
204,2,"Electricity Service",2,11,22,2,24
205,2,"Window Cleaning Service",9,21,189,19,208
206,3,"Window Cleaning Service",2,22,44,4,48
207,3,"Gas Service",10,42,420,42,462
208,4,"Flooring Service",4,47,188,19,207
209,4,"Gas Service",3,11,33,3,36
210,5,"Window Cleaning Service",6,28,168,17,185
211,5,"Electricity Service",6,28,168,17,185
212,6,"Flooring Service",4,15,60,6,66
213,6,"AC Maintenance Service",3,29,87,9,96
214,7,"Gas Service",5,34,170,17,187
215,7,"AC Maintenance Service",5,29,145,15,160
216,8,"Plumber Service",7,23,161,16,177
217,8,"Gas Service",5,38,190,19,209
218,9,"Plumber Service",1,37,37,4,41
219,9,"Electricity Service",8,13,104,10,114
220,10,"Plumber Service",6,14,84,8,92
221,10,"Plumber Service",10,17,170,17,187
222,11,"Window Cleaning Service",2,23,46,5,51
223,11,"Window Cleaning Service",2,46,92,9,101
224,12,"Window Cleaning Service",3,25,75,8,83
225,12,"Electricity Service",6,47,282,28,310
226,13,"Electricity Service",9,41,369,37,406
227,13,"Gas Service",3,40,120,12,132
228,14,"Plumber Service",3,32,96,10,106
229,14,"Gas Service",4,37,148,15,163
230,15,"Window Cleaning Service",3,29,87,9,96
231,15,"Plumber Service",1,42,42,4,46
232,16,"Flooring Service",2,14,28,3,31
233,16,"Electricity Service",10,16,160,16,176
234,17,"Gas Service",2,44,88,9,97
235,17,"Electricity Service",4,41,164,16,180
236,18,"AC Maintenance Service",9,24,216,22,238
237,18,"Gas Service",5,44,220,22,242
238,19,"Gas Service",10,29,290,29,319
239,19,"Flooring Service",1,48,48,5,53
240,20,"Window Cleaning Service",1,43,43,4,47
241,20,"Electricity Service",8,41,328,33,361
242,21,"Flooring Service",1,48,48,5,53
243,21,"Gas Service",6,32,192,19,211
244,22,"Electricity Service",2,44,88,9,97
245,22,"Flooring Service",8,40,320,32,352
246,23,"Plumber Service",6,24,144,14,158
247,23,"Window Cleaning Service",7,16,112,11,123
248,24,"Electricity Service",7,50,350,35,385
249,24,"Electricity Service",4,25,100,10,110
250,25,"Plumber Service",6,49,294,29,323
251,25,"Window Cleaning Service",3,43,129,13,142
252,26,"Electricity Service",4,26,104,10,114
253,26,"AC Maintenance Service",7,48,336,34,370
254,27,"Electricity Service",1,13,13,1,14
255,27,"Flooring Service",5,24,120,12,132
256,28,"Window Cleaning Service",1,11,11,1,12
257,28,"Plumber Service",6,50,300,30,330
258,29,"Flooring Service",7,50,350,35,385
259,29,"Flooring Service",6,39,234,23,257
260,30,"Window Cleaning Service",9,25,225,23,248
261,30,"Electricity Service",9,42,378,38,416
262,31,"Electricity Service",8,37,296,30,326
263,31,"Window Cleaning Service",8,46,368,37,405
264,32,"Gas Service",1,25,25,3,28
265,32,"Window Cleaning Service",10,27,270,27,297
266,33,"Electricity Service",9,42,378,38,416
267,33,"Window Cleaning Service",9,47,423,42,465
268,34,"Plumber Service",7,11,77,8,85
269,34,"Electricity Service",5,41,205,21,226
270,35,"AC Maintenance Service",1,26,26,3,29
271,35,"Gas Service",1,28,28,3,31
272,36,"Plumber Service",7,39,273,27,300
273,36,"Window Cleaning Service",2,28,56,6,62
274,37,"Flooring Service",8,50,400,40,440
275,37,"Gas Service",6,23,138,14,152
276,38,"Plumber Service",1,50,50,5,55
277,38,"Flooring Service",10,27,270,27,297
278,39,"Flooring Service",7,35,245,25,270
279,39,"Electricity Service",4,36,144,14,158
280,40,"Window Cleaning Service",1,35,35,4,39
281,40,"Window Cleaning Service",2,14,28,3,31
282,41,"Flooring Service",4,48,192,19,211
283,41,"Electricity Service",4,49,196,20,216
284,42,"Gas Service",2,27,54,5,59
285,42,"Window Cleaning Service",10,29,290,29,319
286,43,"Flooring Service",6,14,84,8,92
287,43,"Electricity Service",4,50,200,20,220
288,44,"Gas Service",4,20,80,8,88
289,44,"Flooring Service",7,30,210,21,231
290,45,"Plumber Service",5,25,125,13,138
291,45,"Plumber Service",9,50,450,45,495
292,46,"Flooring Service",5,12,60,6,66
293,46,"AC Maintenance Service",3,25,75,8,83
294,47,"Plumber Service",4,46,184,18,202
295,47,"Gas Service",7,22,154,15,169
296,48,"Plumber Service",10,28,280,28,308
297,48,"Electricity Service",9,10,90,9,99
298,49,"Flooring Service",10,50,500,50,550
299,49,"AC Maintenance Service",6,23,138,14,152
300,50,"AC Maintenance Service",1,50,50,5,55
301,50,"Window Cleaning Service",2,37,74,7,81
302,51,"AC Maintenance Service",4,11,44,4,48
303,51,"Gas Service",8,43,344,34,378
304,52,"Plumber Service",8,45,360,36,396
305,52,"Window Cleaning Service",7,41,287,29,316
306,53,"AC Maintenance Service",7,48,336,34,370
307,53,"AC Maintenance Service",10,47,470,47,517
308,54,"Plumber Service",1,36,36,4,40
309,54,"Plumber Service",1,43,43,4,47
310,55,"AC Maintenance Service",10,15,150,15,165
311,55,"Plumber Service",8,14,112,11,123
312,56,"Gas Service",3,37,111,11,122
313,56,"Electricity Service",6,33,198,20,218
314,57,"Flooring Service",9,24,216,22,238
315,57,"Electricity Service",5,19,95,10,105
316,58,"Flooring Service",6,42,252,25,277
317,58,"Plumber Service",1,13,13,1,14
318,59,"Electricity Service",2,33,66,7,73
319,59,"Plumber Service",2,43,86,9,95
320,60,"Gas Service",10,29,290,29,319
321,60,"Electricity Service",8,39,312,31,343
322,61,"Window Cleaning Service",8,41,328,33,361
323,61,"AC Maintenance Service",8,21,168,17,185
324,62,"Window Cleaning Service",6,21,126,13,139
325,62,"Flooring Service",3,26,78,8,86
326,63,"Electricity Service",4,45,180,18,198
327,63,"AC Maintenance Service",3,39,117,12,129
328,64,"Flooring Service",1,13,13,1,14
329,64,"Electricity Service",9,32,288,29,317
330,65,"Flooring Service",6,23,138,14,152
331,65,"Flooring Service",6,20,120,12,132
332,66,"Window Cleaning Service",4,50,200,20,220
333,66,"Window Cleaning Service",2,18,36,4,40
334,67,"Window Cleaning Service",7,21,147,15,162
335,67,"AC Maintenance Service",1,40,40,4,44
336,68,"Window Cleaning Service",9,29,261,26,287
337,68,"Flooring Service",4,15,60,6,66
338,69,"Plumber Service",9,42,378,38,416
339,69,"Gas Service",10,49,490,49,539
340,70,"Window Cleaning Service",6,20,120,12,132
341,70,"AC Maintenance Service",3,16,48,5,53
342,71,"AC Maintenance Service",10,50,500,50,550
343,71,"Plumber Service",4,38,152,15,167
344,72,"Electricity Service",1,35,35,4,39
345,72,"Electricity Service",8,18,144,14,158
346,73,"Gas Service",1,29,29,3,32
347,73,"Plumber Service",3,40,120,12,132
348,74,"Gas Service",1,21,21,2,23
349,74,"Electricity Service",8,50,400,40,440
350,75,"Window Cleaning Service",5,26,130,13,143
351,75,"Plumber Service",1,29,29,3,32
352,76,"Gas Service",5,36,180,18,198
353,76,"Window Cleaning Service",2,17,34,3,37
354,77,"Electricity Service",8,21,168,17,185
355,77,"Flooring Service",7,38,266,27,293
356,78,"AC Maintenance Service",1,36,36,4,40
357,78,"Flooring Service",8,14,112,11,123
358,79,"Gas Service",5,24,120,12,132
359,79,"Electricity Service",3,44,132,13,145
360,80,"Electricity Service",3,47,141,14,155
361,80,"Flooring Service",1,30,30,3,33
362,81,"AC Maintenance Service",1,15,15,2,17
363,81,"Plumber Service",5,46,230,23,253
364,82,"Electricity Service",10,47,470,47,517
365,82,"Window Cleaning Service",6,24,144,14,158
366,83,"Electricity Service",2,50,100,10,110
367,83,"AC Maintenance Service",1,35,35,4,39
368,84,"AC Maintenance Service",10,47,470,47,517
369,84,"Flooring Service",3,30,90,9,99
370,85,"Window Cleaning Service",9,16,144,14,158
371,85,"Plumber Service",9,28,252,25,277
372,86,"AC Maintenance Service",6,41,246,25,271
373,86,"Plumber Service",1,39,39,4,43
374,87,"Plumber Service",1,18,18,2,20
375,87,"Flooring Service",7,17,119,12,131
376,88,"AC Maintenance Service",6,36,216,22,238
377,88,"AC Maintenance Service",10,22,220,22,242
378,89,"Window Cleaning Service",5,14,70,7,77
379,89,"Plumber Service",5,27,135,14,149
380,90,"Electricity Service",2,22,44,4,48
381,90,"Flooring Service",10,31,310,31,341
382,91,"Window Cleaning Service",4,50,200,20,220
383,91,"Electricity Service",6,15,90,9,99
384,92,"Gas Service",7,45,315,32,347
385,92,"Window Cleaning Service",7,21,147,15,162
386,93,"Electricity Service",2,30,60,6,66
387,93,"Electricity Service",4,29,116,12,128
388,94,"AC Maintenance Service",2,25,50,5,55
389,94,"Gas Service",5,13,65,7,72
390,95,"Window Cleaning Service",4,27,108,11,119
391,95,"Plumber Service",2,19,38,4,42
392,96,"Gas Service",9,15,135,14,149
393,96,"Flooring Service",7,38,266,27,293
394,97,"AC Maintenance Service",7,38,266,27,293
395,97,"Electricity Service",9,33,297,30,327
396,98,"Gas Service",4,44,176,18,194
397,98,"Plumber Service",4,20,80,8,88
398,99,"Electricity Service",8,47,376,38,414
399,99,"Plumber Service",8,17,136,14,150
400,100,"Flooring Service",2,26,52,5,57
401,100,"Gas Service",8,41,328,33,361
402,101,"Plumber Service",9,31,279,28,307
403,101,"AC Maintenance Service",2,22,44,4,48
404,102,"AC Maintenance Service",6,48,288,29,317
405,102,"Window Cleaning Service",1,48,48,5,53
406,103,"AC Maintenance Service",7,20,140,14,154
407,103,"Electricity Service",9,49,441,44,485
408,104,"Window Cleaning Service",7,32,224,22,246
409,104,"Plumber Service",3,16,48,5,53
410,105,"Electricity Service",2,16,32,3,35
411,105,"Window Cleaning Service",9,46,414,41,455
412,106,"Plumber Service",3,42,126,13,139
413,106,"AC Maintenance Service",7,43,301,30,331
414,107,"Gas Service",1,39,39,4,43
415,107,"Gas Service",4,28,112,11,123
416,108,"Window Cleaning Service",3,39,117,12,129
417,108,"AC Maintenance Service",2,45,90,9,99
418,109,"Electricity Service",4,18,72,7,79
419,109,"Flooring Service",4,21,84,8,92
420,110,"AC Maintenance Service",7,36,252,25,277
421,110,"Electricity Service",9,14,126,13,139
422,111,"Window Cleaning Service",7,46,322,32,354
423,111,"Plumber Service",1,24,24,2,26
424,112,"Window Cleaning Service",3,31,93,9,102
425,112,"Window Cleaning Service",10,28,280,28,308
426,113,"Plumber Service",3,24,72,7,79
427,113,"AC Maintenance Service",2,30,60,6,66
428,114,"Flooring Service",6,24,144,14,158
429,114,"Gas Service",2,15,30,3,33
430,115,"Flooring Service",5,22,110,11,121
431,115,"Electricity Service",5,50,250,25,275
432,116,"Electricity Service",7,32,224,22,246
433,116,"Window Cleaning Service",10,17,170,17,187
434,117,"Window Cleaning Service",8,19,152,15,167
435,117,"Electricity Service",5,17,85,9,94
436,118,"Gas Service",8,13,104,10,114
437,118,"Gas Service",8,48,384,38,422
438,119,"Window Cleaning Service",1,43,43,4,47
439,119,"AC Maintenance Service",7,25,175,18,193
440,120,"Gas Service",4,32,128,13,141
441,120,"Window Cleaning Service",3,42,126,13,139
442,121,"Electricity Service",7,11,77,8,85
443,121,"AC Maintenance Service",6,46,276,28,304
444,122,"Plumber Service",6,35,210,21,231
445,122,"Electricity Service",6,20,120,12,132
446,123,"AC Maintenance Service",2,30,60,6,66
447,123,"Electricity Service",10,44,440,44,484
448,124,"AC Maintenance Service",4,30,120,12,132
449,124,"AC Maintenance Service",8,20,160,16,176
450,125,"Flooring Service",7,19,133,13,146
451,125,"Plumber Service",8,14,112,11,123
452,126,"Flooring Service",2,45,90,9,99
453,126,"Electricity Service",3,26,78,8,86
454,127,"Plumber Service",9,26,234,23,257
455,127,"Plumber Service",3,41,123,12,135
456,128,"Flooring Service",7,47,329,33,362
457,128,"Electricity Service",3,19,57,6,63
458,129,"Plumber Service",5,48,240,24,264
459,129,"AC Maintenance Service",1,25,25,3,28
460,130,"Electricity Service",1,30,30,3,33
461,130,"AC Maintenance Service",1,46,46,5,51
462,131,"Flooring Service",2,24,48,5,53
463,131,"Flooring Service",2,29,58,6,64
464,132,"AC Maintenance Service",6,47,282,28,310
465,132,"AC Maintenance Service",2,17,34,3,37
466,133,"Plumber Service",2,40,80,8,88
467,133,"Electricity Service",10,11,110,11,121
468,134,"Plumber Service",2,30,60,6,66
469,134,"Window Cleaning Service",9,21,189,19,208
470,135,"Gas Service",10,27,270,27,297
471,135,"AC Maintenance Service",4,40,160,16,176
472,136,"Gas Service",1,22,22,2,24
473,136,"AC Maintenance Service",7,18,126,13,139
474,137,"Gas Service",3,43,129,13,142
475,137,"AC Maintenance Service",6,19,114,11,125
476,138,"Window Cleaning Service",8,31,248,25,273
477,138,"Window Cleaning Service",1,36,36,4,40
478,139,"Plumber Service",1,11,11,1,12
479,139,"Gas Service",2,27,54,5,59
480,140,"Flooring Service",8,25,200,20,220
481,140,"Plumber Service",2,41,82,8,90
482,141,"Window Cleaning Service",9,42,378,38,416
483,141,"Flooring Service",9,36,324,32,356
484,142,"Flooring Service",10,30,300,30,330
485,142,"Plumber Service",2,20,40,4,44
486,143,"Electricity Service",7,27,189,19,208
487,143,"AC Maintenance Service",4,17,68,7,75
488,144,"Plumber Service",4,16,64,6,70
489,144,"Window Cleaning Service",2,36,72,7,79
490,145,"Window Cleaning Service",7,15,105,11,116
491,145,"Window Cleaning Service",3,10,30,3,33
492,146,"Electricity Service",4,32,128,13,141
493,146,"Plumber Service",4,10,40,4,44
494,147,"AC Maintenance Service",2,13,26,3,29
495,147,"AC Maintenance Service",5,46,230,23,253
496,148,"Flooring Service",8,32,256,26,282
497,148,"Electricity Service",4,22,88,9,97
498,149,"Window Cleaning Service",9,38,342,34,376
499,149,"Window Cleaning Service",6,18,108,11,119
500,150,"Gas Service",6,49,294,29,323
501,150,"Electricity Service",5,10,50,5,55
502,151,"AC Maintenance Service",10,19,190,19,209
503,151,"Window Cleaning Service",6,24,144,14,158
504,152,"Plumber Service",6,18,108,11,119
505,152,"Gas Service",10,14,140,14,154
506,153,"Plumber Service",7,36,252,25,277
507,153,"Flooring Service",7,11,77,8,85
508,154,"Window Cleaning Service",7,34,238,24,262
509,154,"Window Cleaning Service",6,20,120,12,132
510,155,"AC Maintenance Service",3,32,96,10,106
511,155,"Window Cleaning Service",7,17,119,12,131
512,156,"AC Maintenance Service",9,25,225,23,248
513,156,"Electricity Service",4,15,60,6,66
514,157,"Electricity Service",8,33,264,26,290
515,157,"Window Cleaning Service",4,33,132,13,145
516,158,"Window Cleaning Service",4,25,100,10,110
517,158,"Gas Service",5,15,75,8,83
518,159,"AC Maintenance Service",9,37,333,33,366
519,159,"Gas Service",4,21,84,8,92
520,160,"Flooring Service",4,27,108,11,119
521,160,"Window Cleaning Service",8,14,112,11,123
522,161,"Gas Service",9,50,450,45,495
523,161,"Window Cleaning Service",7,16,112,11,123
524,162,"AC Maintenance Service",1,17,17,2,19
525,162,"Electricity Service",1,39,39,4,43
526,163,"Plumber Service",10,33,330,33,363
527,163,"Gas Service",9,15,135,14,149
528,164,"Plumber Service",6,39,234,23,257
529,164,"Electricity Service",7,12,84,8,92
530,165,"Plumber Service",3,42,126,13,139
531,165,"Flooring Service",8,19,152,15,167
532,166,"Flooring Service",10,19,190,19,209
533,166,"Plumber Service",1,36,36,4,40
534,167,"Window Cleaning Service",1,15,15,2,17
535,167,"AC Maintenance Service",1,49,49,5,54
536,168,"Flooring Service",9,23,207,21,228
537,168,"AC Maintenance Service",1,10,10,1,11
538,169,"Flooring Service",2,30,60,6,66
539,169,"AC Maintenance Service",2,48,96,10,106
540,170,"Flooring Service",5,23,115,12,127
541,170,"Flooring Service",9,17,153,15,168
542,171,"Flooring Service",7,14,98,10,108
543,171,"Flooring Service",9,18,162,16,178
544,172,"AC Maintenance Service",8,23,184,18,202
545,172,"Electricity Service",1,37,37,4,41
546,173,"Plumber Service",8,16,128,13,141
547,173,"Gas Service",10,38,380,38,418
548,174,"AC Maintenance Service",1,19,19,2,21
549,174,"Flooring Service",4,30,120,12,132
550,175,"Plumber Service",3,30,90,9,99
551,175,"Flooring Service",8,47,376,38,414
552,176,"Electricity Service",6,37,222,22,244
553,176,"Flooring Service",9,24,216,22,238
554,177,"Window Cleaning Service",10,20,200,20,220
555,177,"AC Maintenance Service",5,25,125,13,138
556,178,"Electricity Service",1,35,35,4,39
557,178,"Flooring Service",3,30,90,9,99
558,179,"Electricity Service",8,38,304,30,334
559,179,"Flooring Service",10,34,340,34,374
560,180,"Flooring Service",8,50,400,40,440
561,180,"AC Maintenance Service",5,28,140,14,154
562,181,"Flooring Service",10,14,140,14,154
563,181,"Gas Service",6,17,102,10,112
564,182,"Gas Service",5,43,215,22,237
565,182,"AC Maintenance Service",9,47,423,42,465
566,183,"Gas Service",7,45,315,32,347
567,183,"Flooring Service",7,24,168,17,185
568,184,"Flooring Service",1,13,13,1,14
569,184,"Plumber Service",7,15,105,11,116
570,185,"Electricity Service",10,43,430,43,473
571,185,"Gas Service",2,14,28,3,31
572,186,"Flooring Service",7,46,322,32,354
573,186,"AC Maintenance Service",10,43,430,43,473
574,187,"Flooring Service",10,39,390,39,429
575,187,"Plumber Service",5,34,170,17,187
576,188,"AC Maintenance Service",8,14,112,11,123
577,188,"AC Maintenance Service",7,41,287,29,316
578,189,"Plumber Service",3,14,42,4,46
579,189,"AC Maintenance Service",1,49,49,5,54
580,190,"Flooring Service",3,24,72,7,79
581,190,"AC Maintenance Service",2,47,94,9,103
582,191,"Gas Service",1,29,29,3,32
583,191,"Window Cleaning Service",6,23,138,14,152
584,192,"Electricity Service",2,19,38,4,42
585,192,"Electricity Service",7,40,280,28,308
586,193,"Window Cleaning Service",10,23,230,23,253
587,193,"Flooring Service",3,40,120,12,132
588,194,"AC Maintenance Service",4,10,40,4,44
589,194,"AC Maintenance Service",3,40,120,12,132
590,195,"AC Maintenance Service",8,39,312,31,343
591,195,"Gas Service",9,44,396,40,436
592,196,"AC Maintenance Service",9,34,306,31,337
593,196,"Electricity Service",8,31,248,25,273
594,197,"Electricity Service",6,12,72,7,79
595,197,"Flooring Service",3,10,30,3,33
596,198,"Window Cleaning Service",9,18,162,16,178
597,198,"Plumber Service",10,13,130,13,143
598,199,"Plumber Service",6,41,246,25,271
599,199,"Electricity Service",8,18,144,14,158
600,200,"Flooring Service",8,37,296,30,326
601,200,"Gas Service",10,25,250,25,275
602,201,"Electricity Service",1,28,28,3,31
603,201,"Gas Service",8,32,256,26,282
604,202,"AC Maintenance Service",3,29,87,9,96
605,202,"Electricity Service",10,44,440,44,484
606,203,"Electricity Service",1,31,31,3,34
607,203,"Electricity Service",5,16,80,8,88
608,204,"Electricity Service",3,37,111,11,122
609,204,"Plumber Service",9,40,360,36,396
610,205,"Plumber Service",4,24,96,10,106
611,205,"Window Cleaning Service",9,48,432,43,475
612,206,"Electricity Service",3,32,96,10,106
613,206,"Window Cleaning Service",2,41,82,8,90
614,207,"Window Cleaning Service",2,14,28,3,31
615,207,"Gas Service",1,28,28,3,31
616,208,"Plumber Service",1,30,30,3,33
617,208,"Gas Service",4,13,52,5,57
618,209,"Electricity Service",4,16,64,6,70
619,209,"Flooring Service",6,30,180,18,198
620,210,"Flooring Service",6,50,300,30,330
621,210,"Plumber Service",4,16,64,6,70
622,211,"Gas Service",7,23,161,16,177
623,211,"Flooring Service",9,36,324,32,356
624,212,"Flooring Service",5,35,175,18,193
625,212,"Electricity Service",9,10,90,9,99
626,213,"Plumber Service",5,14,70,7,77
627,213,"Electricity Service",6,28,168,17,185
628,214,"Flooring Service",6,18,108,11,119
629,214,"Plumber Service",5,10,50,5,55
630,215,"Flooring Service",2,31,62,6,68
631,215,"Plumber Service",5,43,215,22,237
632,216,"AC Maintenance Service",3,45,135,14,149
633,216,"Gas Service",4,18,72,7,79
634,217,"AC Maintenance Service",6,43,258,26,284
635,217,"Gas Service",8,23,184,18,202
636,218,"Window Cleaning Service",3,12,36,4,40
637,218,"Gas Service",7,30,210,21,231
638,219,"Flooring Service",7,48,336,34,370
639,219,"Gas Service",2,20,40,4,44
640,220,"Gas Service",7,33,231,23,254
641,220,"Gas Service",5,41,205,21,226
642,221,"Plumber Service",8,44,352,35,387
643,221,"AC Maintenance Service",6,34,204,20,224
644,222,"Plumber Service",6,30,180,18,198
645,222,"Window Cleaning Service",4,20,80,8,88
646,223,"Flooring Service",8,39,312,31,343
647,223,"Electricity Service",3,39,117,12,129
648,224,"Plumber Service",2,41,82,8,90
649,224,"Gas Service",6,48,288,29,317
650,225,"Plumber Service",4,38,152,15,167
651,225,"Plumber Service",3,23,69,7,76
652,226,"AC Maintenance Service",4,12,48,5,53
653,226,"Plumber Service",9,40,360,36,396
654,227,"AC Maintenance Service",8,34,272,27,299
655,227,"Electricity Service",3,48,144,14,158
656,228,"Gas Service",6,34,204,20,224
657,228,"Flooring Service",9,47,423,42,465
658,229,"Gas Service",3,17,51,5,56
659,229,"Window Cleaning Service",2,34,68,7,75
660,230,"Window Cleaning Service",8,45,360,36,396
661,230,"AC Maintenance Service",3,42,126,13,139
662,231,"AC Maintenance Service",5,32,160,16,176
663,231,"AC Maintenance Service",5,15,75,8,83
664,232,"Flooring Service",10,11,110,11,121
665,232,"Flooring Service",5,19,95,10,105
666,233,"Plumber Service",4,43,172,17,189
667,233,"AC Maintenance Service",8,19,152,15,167
668,234,"Flooring Service",1,34,34,3,37
669,234,"Gas Service",8,16,128,13,141
670,235,"Flooring Service",10,21,210,21,231
671,235,"Flooring Service",10,28,280,28,308
672,236,"Flooring Service",9,33,297,30,327
673,236,"Gas Service",6,18,108,11,119
674,237,"AC Maintenance Service",2,20,40,4,44
675,237,"Flooring Service",5,21,105,11,116
676,238,"Flooring Service",2,12,24,2,26
677,238,"Plumber Service",10,35,350,35,385
678,239,"Plumber Service",2,26,52,5,57
679,239,"Window Cleaning Service",9,36,324,32,356
680,240,"AC Maintenance Service",9,15,135,14,149
681,240,"Plumber Service",10,32,320,32,352
682,241,"Window Cleaning Service",1,27,27,3,30
683,241,"Gas Service",4,16,64,6,70
684,242,"Plumber Service",2,13,26,3,29
685,242,"AC Maintenance Service",7,10,70,7,77
686,243,"Gas Service",6,49,294,29,323
687,243,"Flooring Service",4,42,168,17,185
688,244,"Window Cleaning Service",5,40,200,20,220
689,244,"Window Cleaning Service",1,46,46,5,51
690,245,"AC Maintenance Service",8,16,128,13,141
691,245,"Electricity Service",1,24,24,2,26
692,246,"Gas Service",5,40,200,20,220
693,246,"Flooring Service",8,24,192,19,211
694,247,"Gas Service",3,31,93,9,102
695,247,"AC Maintenance Service",6,49,294,29,323
696,248,"Gas Service",1,38,38,4,42
697,248,"Gas Service",10,35,350,35,385
698,249,"Electricity Service",8,39,312,31,343
699,249,"Flooring Service",4,15,60,6,66
700,250,"Gas Service",5,34,170,17,187
701,250,"Electricity Service",8,24,192,19,211
702,251,"AC Maintenance Service",2,48,96,10,106
703,251,"Plumber Service",8,28,224,22,246
704,252,"Flooring Service",5,24,120,12,132
705,252,"Flooring Service",10,18,180,18,198
706,253,"Window Cleaning Service",5,40,200,20,220
707,253,"Flooring Service",5,50,250,25,275
708,254,"Electricity Service",5,50,250,25,275
709,254,"Flooring Service",5,45,225,23,248
710,255,"Plumber Service",5,41,205,21,226
711,255,"Flooring Service",9,37,333,33,366
712,256,"Window Cleaning Service",6,14,84,8,92
713,256,"Window Cleaning Service",2,28,56,6,62
714,257,"AC Maintenance Service",4,15,60,6,66
715,257,"Window Cleaning Service",4,45,180,18,198
716,258,"Window Cleaning Service",8,16,128,13,141
717,258,"Flooring Service",7,21,147,15,162
718,259,"Flooring Service",2,29,58,6,64
719,259,"Window Cleaning Service",1,42,42,4,46
720,260,"Plumber Service",8,45,360,36,396
721,260,"Electricity Service",1,42,42,4,46
722,261,"Window Cleaning Service",5,36,180,18,198
723,261,"Window Cleaning Service",10,41,410,41,451
724,262,"Plumber Service",10,11,110,11,121
725,262,"Gas Service",4,26,104,10,114
726,263,"Flooring Service",6,14,84,8,92
727,263,"Electricity Service",10,23,230,23,253
728,264,"Flooring Service",5,14,70,7,77
729,264,"Plumber Service",3,17,51,5,56
730,265,"Window Cleaning Service",9,31,279,28,307
731,265,"Window Cleaning Service",1,50,50,5,55
732,266,"Flooring Service",1,21,21,2,23
733,266,"AC Maintenance Service",9,44,396,40,436
734,267,"Flooring Service",8,27,216,22,238
735,267,"Electricity Service",4,25,100,10,110
736,268,"AC Maintenance Service",9,13,117,12,129
737,268,"Plumber Service",7,49,343,34,377
738,269,"Window Cleaning Service",10,46,460,46,506
739,269,"Gas Service",4,26,104,10,114
740,270,"AC Maintenance Service",3,33,99,10,109
741,270,"AC Maintenance Service",8,20,160,16,176
742,271,"Window Cleaning Service",7,31,217,22,239
743,271,"AC Maintenance Service",4,31,124,12,136
744,272,"Plumber Service",10,18,180,18,198
745,272,"Gas Service",10,36,360,36,396
746,273,"Flooring Service",6,26,156,16,172
747,273,"AC Maintenance Service",4,14,56,6,62
748,274,"Gas Service",8,49,392,39,431
749,274,"Gas Service",2,12,24,2,26
750,275,"AC Maintenance Service",5,38,190,19,209
751,275,"Gas Service",4,10,40,4,44
752,276,"Electricity Service",3,31,93,9,102
753,276,"Plumber Service",4,17,68,7,75
754,277,"Window Cleaning Service",6,41,246,25,271
755,277,"AC Maintenance Service",4,45,180,18,198
756,278,"Flooring Service",2,46,92,9,101
757,278,"Plumber Service",10,39,390,39,429
758,279,"Window Cleaning Service",7,27,189,19,208
759,279,"Plumber Service",1,48,48,5,53
760,280,"Gas Service",8,13,104,10,114
761,280,"Flooring Service",1,24,24,2,26
762,281,"Window Cleaning Service",2,26,52,5,57
763,281,"Gas Service",1,15,15,2,17
764,282,"Plumber Service",8,30,240,24,264
765,282,"Flooring Service",6,17,102,10,112
766,283,"Window Cleaning Service",1,19,19,2,21
767,283,"Electricity Service",5,13,65,7,72
768,284,"Gas Service",4,17,68,7,75
769,284,"Gas Service",5,36,180,18,198
770,285,"Window Cleaning Service",2,11,22,2,24
771,285,"Plumber Service",9,49,441,44,485
772,286,"Electricity Service",3,44,132,13,145
773,286,"Gas Service",4,37,148,15,163
774,287,"Flooring Service",1,19,19,2,21
775,287,"Electricity Service",2,48,96,10,106
776,288,"Gas Service",8,19,152,15,167
777,288,"Flooring Service",3,18,54,5,59
778,289,"Window Cleaning Service",9,31,279,28,307
779,289,"Window Cleaning Service",4,24,96,10,106
780,290,"Window Cleaning Service",6,39,234,23,257
781,290,"Window Cleaning Service",3,18,54,5,59
782,291,"Gas Service",4,26,104,10,114
783,291,"Window Cleaning Service",1,21,21,2,23
784,292,"Window Cleaning Service",8,46,368,37,405
785,292,"Gas Service",7,46,322,32,354
786,293,"AC Maintenance Service",2,50,100,10,110
787,293,"Window Cleaning Service",5,35,175,18,193
788,294,"Plumber Service",3,22,66,7,73
789,294,"Window Cleaning Service",8,42,336,34,370
790,295,"Flooring Service",2,49,98,10,108
791,295,"Electricity Service",5,29,145,15,160
792,296,"Window Cleaning Service",8,16,128,13,141
793,296,"AC Maintenance Service",3,29,87,9,96
794,297,"Window Cleaning Service",5,45,225,23,248
795,297,"Gas Service",3,26,78,8,86
796,298,"AC Maintenance Service",8,25,200,20,220
797,298,"Window Cleaning Service",8,27,216,22,238
798,299,"Gas Service",3,22,66,7,73
799,299,"AC Maintenance Service",6,49,294,29,323
800,300,"Flooring Service",3,40,120,12,132
801,300,"AC Maintenance Service",9,43,387,39,426
802,301,"Gas Service",10,49,490,49,539
803,301,"Flooring Service",7,11,77,8,85
804,302,"Flooring Service",3,27,81,8,89
805,302,"Flooring Service",10,24,240,24,264
806,303,"Gas Service",7,47,329,33,362
807,303,"AC Maintenance Service",7,20,140,14,154
808,304,"Gas Service",5,35,175,18,193
809,304,"Flooring Service",9,37,333,33,366
810,305,"AC Maintenance Service",5,31,155,16,171
811,305,"Window Cleaning Service",10,45,450,45,495
812,306,"Gas Service",7,30,210,21,231
813,306,"Gas Service",1,23,23,2,25
814,307,"Flooring Service",1,36,36,4,40
815,307,"Gas Service",5,44,220,22,242
816,308,"AC Maintenance Service",3,43,129,13,142
817,308,"Flooring Service",8,37,296,30,326
818,309,"Gas Service",6,13,78,8,86
819,309,"AC Maintenance Service",2,28,56,6,62
820,310,"Window Cleaning Service",6,13,78,8,86
821,310,"AC Maintenance Service",8,46,368,37,405
822,311,"Flooring Service",1,47,47,5,52
823,311,"Gas Service",9,34,306,31,337
824,312,"Flooring Service",5,28,140,14,154
825,312,"Window Cleaning Service",7,30,210,21,231
826,313,"Window Cleaning Service",5,33,165,17,182
827,313,"Window Cleaning Service",7,31,217,22,239
828,314,"Window Cleaning Service",5,43,215,22,237
829,314,"Electricity Service",1,34,34,3,37
830,315,"Window Cleaning Service",5,39,195,20,215
831,315,"Electricity Service",6,50,300,30,330
832,316,"AC Maintenance Service",10,10,100,10,110
833,316,"Electricity Service",2,42,84,8,92
834,317,"Electricity Service",9,38,342,34,376
835,317,"Gas Service",6,34,204,20,224
836,318,"Plumber Service",5,16,80,8,88
837,318,"AC Maintenance Service",1,49,49,5,54
838,319,"Flooring Service",3,18,54,5,59
839,319,"Plumber Service",4,33,132,13,145
840,320,"AC Maintenance Service",7,49,343,34,377
841,320,"Gas Service",9,33,297,30,327
842,321,"Window Cleaning Service",2,35,70,7,77
843,321,"Gas Service",1,13,13,1,14
844,322,"Plumber Service",1,37,37,4,41
845,322,"Plumber Service",6,43,258,26,284
846,323,"Flooring Service",6,16,96,10,106
847,323,"AC Maintenance Service",5,31,155,16,171
848,324,"Plumber Service",7,47,329,33,362
849,324,"Gas Service",5,39,195,20,215
850,325,"Flooring Service",6,39,234,23,257
851,325,"Electricity Service",8,17,136,14,150
852,326,"Plumber Service",6,14,84,8,92
853,326,"Flooring Service",10,32,320,32,352
854,327,"Window Cleaning Service",9,28,252,25,277
855,327,"Plumber Service",10,29,290,29,319
856,328,"Gas Service",4,13,52,5,57
857,328,"Electricity Service",7,46,322,32,354
858,329,"Electricity Service",9,14,126,13,139
859,329,"Gas Service",1,41,41,4,45
860,330,"Window Cleaning Service",5,12,60,6,66
861,330,"Electricity Service",9,20,180,18,198
862,331,"Window Cleaning Service",6,26,156,16,172
863,331,"Window Cleaning Service",5,26,130,13,143
864,332,"Gas Service",1,20,20,2,22
865,332,"Window Cleaning Service",2,19,38,4,42
866,333,"AC Maintenance Service",4,49,196,20,216
867,333,"Plumber Service",10,35,350,35,385
868,334,"Gas Service",9,32,288,29,317
869,334,"AC Maintenance Service",4,26,104,10,114
870,335,"Plumber Service",8,46,368,37,405
871,335,"Flooring Service",1,19,19,2,21
872,336,"Electricity Service",7,21,147,15,162
873,336,"Window Cleaning Service",9,22,198,20,218
874,337,"Electricity Service",1,29,29,3,32
875,337,"Electricity Service",7,45,315,32,347
876,338,"Window Cleaning Service",8,30,240,24,264
877,338,"Window Cleaning Service",10,27,270,27,297
878,339,"Electricity Service",10,25,250,25,275
879,339,"Window Cleaning Service",10,15,150,15,165
880,340,"Plumber Service",2,42,84,8,92
881,340,"Electricity Service",1,26,26,3,29
882,341,"Window Cleaning Service",1,43,43,4,47
883,341,"Flooring Service",3,48,144,14,158
884,342,"Electricity Service",7,14,98,10,108
885,342,"Window Cleaning Service",6,36,216,22,238
886,343,"Window Cleaning Service",9,27,243,24,267
887,343,"Flooring Service",4,34,136,14,150
888,344,"AC Maintenance Service",5,33,165,17,182
889,344,"Electricity Service",10,50,500,50,550
890,345,"Flooring Service",10,35,350,35,385
891,345,"Window Cleaning Service",3,27,81,8,89
892,346,"Electricity Service",9,20,180,18,198
893,346,"Flooring Service",10,18,180,18,198
894,347,"AC Maintenance Service",5,46,230,23,253
895,347,"Window Cleaning Service",4,47,188,19,207
896,348,"Plumber Service",7,13,91,9,100
897,348,"Electricity Service",10,10,100,10,110
898,349,"Flooring Service",2,44,88,9,97
899,349,"Flooring Service",2,44,88,9,97
900,350,"Flooring Service",1,48,48,5,53
901,350,"Flooring Service",10,39,390,39,429
902,351,"Electricity Service",10,28,280,28,308
903,351,"Flooring Service",6,19,114,11,125
904,352,"Gas Service",2,45,90,9,99
905,352,"AC Maintenance Service",3,45,135,14,149
906,353,"Window Cleaning Service",9,26,234,23,257
907,353,"Window Cleaning Service",10,49,490,49,539
908,354,"Gas Service",8,37,296,30,326
909,354,"Electricity Service",10,33,330,33,363
910,355,"AC Maintenance Service",4,16,64,6,70
911,355,"Electricity Service",8,17,136,14,150
912,356,"AC Maintenance Service",8,38,304,30,334
913,356,"AC Maintenance Service",5,47,235,24,259
914,357,"Window Cleaning Service",10,34,340,34,374
915,357,"Flooring Service",4,21,84,8,92
916,358,"Gas Service",3,45,135,14,149
917,358,"Flooring Service",4,22,88,9,97
918,359,"Gas Service",9,32,288,29,317
919,359,"AC Maintenance Service",1,43,43,4,47
920,360,"Electricity Service",1,26,26,3,29
921,360,"Gas Service",1,18,18,2,20
922,361,"Electricity Service",1,15,15,2,17
923,361,"Gas Service",8,21,168,17,185
924,362,"Window Cleaning Service",10,14,140,14,154
925,362,"Electricity Service",5,12,60,6,66
926,363,"AC Maintenance Service",7,31,217,22,239
927,363,"Gas Service",9,44,396,40,436
928,364,"Plumber Service",8,13,104,10,114
929,364,"Gas Service",7,47,329,33,362
930,365,"Gas Service",5,27,135,14,149
931,365,"Plumber Service",1,41,41,4,45
932,366,"Window Cleaning Service",5,17,85,9,94
933,366,"Flooring Service",9,45,405,41,446
934,367,"Window Cleaning Service",9,49,441,44,485
935,367,"Plumber Service",7,35,245,25,270
936,368,"Plumber Service",3,19,57,6,63
937,368,"Gas Service",6,21,126,13,139
938,369,"AC Maintenance Service",9,13,117,12,129
939,369,"Plumber Service",5,32,160,16,176
940,370,"Flooring Service",6,49,294,29,323
941,370,"Plumber Service",5,33,165,17,182
942,371,"Electricity Service",7,22,154,15,169
943,371,"Plumber Service",6,18,108,11,119
944,372,"Window Cleaning Service",1,24,24,2,26
945,372,"Window Cleaning Service",3,27,81,8,89
946,373,"Window Cleaning Service",7,27,189,19,208
947,373,"Window Cleaning Service",3,16,48,5,53
948,374,"Flooring Service",3,14,42,4,46
949,374,"AC Maintenance Service",10,23,230,23,253
950,375,"Electricity Service",2,28,56,6,62
951,375,"Gas Service",6,45,270,27,297
952,376,"Plumber Service",7,37,259,26,285
953,376,"AC Maintenance Service",9,22,198,20,218
954,377,"AC Maintenance Service",10,24,240,24,264
955,377,"Flooring Service",6,15,90,9,99
956,378,"Plumber Service",8,27,216,22,238
957,378,"Gas Service",3,47,141,14,155
958,379,"Electricity Service",10,13,130,13,143
959,379,"Gas Service",2,40,80,8,88
960,380,"Window Cleaning Service",3,39,117,12,129
961,380,"AC Maintenance Service",6,20,120,12,132
962,381,"Electricity Service",9,48,432,43,475
963,381,"Electricity Service",8,36,288,29,317
964,382,"AC Maintenance Service",10,23,230,23,253
965,382,"Flooring Service",4,45,180,18,198
966,383,"Electricity Service",1,27,27,3,30
967,383,"Flooring Service",8,28,224,22,246
968,384,"Gas Service",8,13,104,10,114
969,384,"Plumber Service",8,47,376,38,414
970,385,"Window Cleaning Service",7,24,168,17,185
971,385,"Window Cleaning Service",3,38,114,11,125
972,386,"Electricity Service",4,21,84,8,92
973,386,"Plumber Service",4,15,60,6,66
974,387,"Electricity Service",8,25,200,20,220
975,387,"Flooring Service",4,46,184,18,202
976,388,"Electricity Service",1,18,18,2,20
977,388,"Window Cleaning Service",4,39,156,16,172
978,389,"Window Cleaning Service",9,34,306,31,337
979,389,"Electricity Service",10,12,120,12,132
980,390,"Window Cleaning Service",6,14,84,8,92
981,390,"Flooring Service",9,38,342,34,376
982,391,"AC Maintenance Service",4,19,76,8,84
983,391,"Electricity Service",5,23,115,12,127
984,392,"Gas Service",8,48,384,38,422
985,392,"AC Maintenance Service",6,20,120,12,132
986,393,"Plumber Service",3,29,87,9,96
987,393,"AC Maintenance Service",8,47,376,38,414
988,394,"Electricity Service",1,45,45,5,50
989,394,"AC Maintenance Service",2,45,90,9,99
990,395,"Electricity Service",3,12,36,4,40
991,395,"Plumber Service",8,21,168,17,185
992,396,"Plumber Service",8,30,240,24,264
993,396,"Plumber Service",6,47,282,28,310
994,397,"AC Maintenance Service",6,49,294,29,323
995,397,"Window Cleaning Service",2,39,78,8,86
996,398,"Plumber Service",7,14,98,10,108
997,398,"Electricity Service",8,50,400,40,440
998,399,"Flooring Service",1,48,48,5,53
999,399,"Plumber Service",10,40,400,40,440
1000,400,"Gas Service",9,37,333,33,366
1001,400,"Flooring Service",5,39,195,20,215
1002,401,"Plumber Service",2,26,52,5,57
1003,401,"Plumber Service",4,16,64,6,70
1004,402,"Flooring Service",8,29,232,23,255
1005,402,"Window Cleaning Service",4,35,140,14,154
1006,403,"AC Maintenance Service",1,48,48,5,53
1007,403,"AC Maintenance Service",10,45,450,45,495
1008,404,"Plumber Service",7,23,161,16,177
1009,404,"Flooring Service",8,26,208,21,229
1010,405,"Electricity Service",8,42,336,34,370
1011,405,"Plumber Service",10,44,440,44,484
1012,406,"Flooring Service",9,18,162,16,178
1013,406,"Electricity Service",6,43,258,26,284
1014,407,"Plumber Service",2,17,34,3,37
1015,407,"Plumber Service",1,49,49,5,54
1016,408,"AC Maintenance Service",7,25,175,18,193
1017,408,"Electricity Service",4,12,48,5,53
1018,409,"AC Maintenance Service",2,32,64,6,70
1019,409,"Window Cleaning Service",4,26,104,10,114
1020,410,"Gas Service",10,31,310,31,341
1021,410,"Window Cleaning Service",8,16,128,13,141
1022,411,"AC Maintenance Service",6,35,210,21,231
1023,411,"Plumber Service",3,21,63,6,69
1024,412,"Flooring Service",10,27,270,27,297
1025,412,"Plumber Service",2,14,28,3,31
1026,413,"Plumber Service",8,17,136,14,150
1027,413,"Gas Service",9,42,378,38,416
1028,414,"AC Maintenance Service",10,22,220,22,242
1029,414,"AC Maintenance Service",1,33,33,3,36
1030,415,"Flooring Service",6,19,114,11,125
1031,415,"Plumber Service",9,23,207,21,228
1032,416,"AC Maintenance Service",2,23,46,5,51
1033,416,"Window Cleaning Service",3,21,63,6,69
1034,417,"Electricity Service",8,24,192,19,211
1035,417,"Gas Service",4,30,120,12,132
1036,418,"Electricity Service",10,45,450,45,495
1037,418,"AC Maintenance Service",2,24,48,5,53
1038,419,"Flooring Service",1,50,50,5,55
1039,419,"Flooring Service",2,49,98,10,108
1040,420,"AC Maintenance Service",3,20,60,6,66
1041,420,"Window Cleaning Service",6,17,102,10,112
1042,421,"Electricity Service",2,27,54,5,59
1043,421,"Gas Service",7,11,77,8,85
1044,422,"Electricity Service",7,30,210,21,231
1045,422,"Plumber Service",3,25,75,8,83
1046,423,"Gas Service",9,34,306,31,337
1047,423,"Flooring Service",5,28,140,14,154
1048,424,"Gas Service",9,20,180,18,198
1049,424,"AC Maintenance Service",2,45,90,9,99
1050,425,"Plumber Service",10,21,210,21,231
1051,425,"Electricity Service",3,20,60,6,66
1052,426,"Electricity Service",7,49,343,34,377
1053,426,"Window Cleaning Service",9,11,99,10,109
1054,427,"Window Cleaning Service",8,39,312,31,343
1055,427,"Window Cleaning Service",9,48,432,43,475
1056,428,"Flooring Service",10,20,200,20,220
1057,428,"Plumber Service",8,30,240,24,264
1058,429,"Window Cleaning Service",2,49,98,10,108
1059,429,"AC Maintenance Service",2,34,68,7,75
1060,430,"Electricity Service",6,48,288,29,317
1061,430,"Flooring Service",8,28,224,22,246
1062,431,"Electricity Service",7,47,329,33,362
1063,431,"Window Cleaning Service",5,14,70,7,77
1064,432,"AC Maintenance Service",8,27,216,22,238
1065,432,"Window Cleaning Service",1,45,45,5,50
1066,433,"Window Cleaning Service",10,35,350,35,385
1067,433,"Flooring Service",5,46,230,23,253
1068,434,"Electricity Service",4,22,88,9,97
1069,434,"Plumber Service",9,45,405,41,446
1070,435,"Plumber Service",8,26,208,21,229
1071,435,"AC Maintenance Service",6,33,198,20,218
1072,436,"Gas Service",2,15,30,3,33
1073,436,"Flooring Service",3,44,132,13,145
1074,437,"AC Maintenance Service",8,11,88,9,97
1075,437,"Window Cleaning Service",5,41,205,21,226
1076,438,"Plumber Service",5,28,140,14,154
1077,438,"Gas Service",1,20,20,2,22
1078,439,"Window Cleaning Service",6,38,228,23,251
1079,439,"AC Maintenance Service",5,29,145,15,160
1080,440,"Flooring Service",2,48,96,10,106
1081,440,"Gas Service",10,25,250,25,275
1082,441,"Window Cleaning Service",1,17,17,2,19
1083,441,"AC Maintenance Service",8,14,112,11,123
1084,442,"Flooring Service",3,45,135,14,149
1085,442,"Window Cleaning Service",10,22,220,22,242
1086,443,"Flooring Service",9,40,360,36,396
1087,443,"Plumber Service",4,48,192,19,211
1088,444,"AC Maintenance Service",9,26,234,23,257
1089,444,"Gas Service",1,33,33,3,36
1090,445,"Plumber Service",9,10,90,9,99
1091,445,"Window Cleaning Service",5,42,210,21,231
1092,446,"Flooring Service",4,33,132,13,145
1093,446,"Gas Service",8,40,320,32,352
1094,447,"Gas Service",8,16,128,13,141
1095,447,"Plumber Service",5,10,50,5,55
1096,448,"Window Cleaning Service",7,18,126,13,139
1097,448,"Electricity Service",8,16,128,13,141
1098,449,"Gas Service",8,31,248,25,273
1099,449,"Electricity Service",4,31,124,12,136
1100,450,"AC Maintenance Service",7,37,259,26,285
1101,450,"Plumber Service",7,46,322,32,354
1102,451,"AC Maintenance Service",6,16,96,10,106
1103,451,"Gas Service",2,40,80,8,88
1104,452,"Plumber Service",2,21,42,4,46
1105,452,"Gas Service",7,50,350,35,385
1106,453,"Plumber Service",7,27,189,19,208
1107,453,"Electricity Service",8,24,192,19,211
1108,454,"Plumber Service",1,45,45,5,50
1109,454,"Window Cleaning Service",5,26,130,13,143
1110,455,"AC Maintenance Service",8,24,192,19,211
1111,455,"Window Cleaning Service",2,43,86,9,95
1112,456,"Window Cleaning Service",7,10,70,7,77
1113,456,"Flooring Service",10,15,150,15,165
1114,457,"Plumber Service",1,25,25,3,28
1115,457,"Plumber Service",3,22,66,7,73
1116,458,"AC Maintenance Service",6,33,198,20,218
1117,458,"AC Maintenance Service",6,46,276,28,304
1118,459,"AC Maintenance Service",8,24,192,19,211
1119,459,"Window Cleaning Service",2,48,96,10,106
1120,460,"Plumber Service",1,30,30,3,33
1121,460,"AC Maintenance Service",10,16,160,16,176
1122,461,"Gas Service",8,10,80,8,88
1123,461,"Electricity Service",3,33,99,10,109
1124,462,"Flooring Service",7,19,133,13,146
1125,462,"Flooring Service",3,50,150,15,165
1126,463,"AC Maintenance Service",3,42,126,13,139
1127,463,"Electricity Service",7,41,287,29,316
1128,464,"AC Maintenance Service",3,32,96,10,106
1129,464,"Electricity Service",5,36,180,18,198
1130,465,"AC Maintenance Service",5,17,85,9,94
1131,465,"Window Cleaning Service",10,14,140,14,154
1132,466,"Electricity Service",9,50,450,45,495
1133,466,"AC Maintenance Service",8,40,320,32,352
1134,467,"Flooring Service",4,40,160,16,176
1135,467,"Gas Service",1,27,27,3,30
1136,468,"Window Cleaning Service",7,39,273,27,300
1137,468,"AC Maintenance Service",1,10,10,1,11
1138,469,"Window Cleaning Service",5,47,235,24,259
1139,469,"Flooring Service",9,42,378,38,416
1140,470,"Gas Service",9,31,279,28,307
1141,470,"Flooring Service",6,17,102,10,112
1142,471,"Plumber Service",5,45,225,23,248
1143,471,"AC Maintenance Service",10,10,100,10,110
1144,472,"Electricity Service",9,11,99,10,109
1145,472,"Gas Service",3,13,39,4,43
1146,473,"Gas Service",2,39,78,8,86
1147,473,"Electricity Service",3,45,135,14,149
1148,474,"Plumber Service",8,41,328,33,361
1149,474,"Electricity Service",2,45,90,9,99
1150,475,"Flooring Service",7,31,217,22,239
1151,475,"Plumber Service",5,32,160,16,176
1152,476,"Electricity Service",1,39,39,4,43
1153,476,"Plumber Service",5,21,105,11,116
1154,477,"Window Cleaning Service",4,43,172,17,189
1155,477,"Window Cleaning Service",1,46,46,5,51
1156,478,"Window Cleaning Service",9,14,126,13,139
1157,478,"AC Maintenance Service",3,44,132,13,145
1158,479,"Flooring Service",4,45,180,18,198
1159,479,"Plumber Service",4,26,104,10,114
1160,480,"AC Maintenance Service",5,37,185,19,204
1161,480,"Window Cleaning Service",10,20,200,20,220
1162,481,"AC Maintenance Service",1,20,20,2,22
1163,481,"Electricity Service",5,15,75,8,83
1164,482,"Flooring Service",3,21,63,6,69
1165,482,"Gas Service",7,24,168,17,185
1166,483,"Electricity Service",8,47,376,38,414
1167,483,"Gas Service",7,46,322,32,354
1168,484,"Electricity Service",1,38,38,4,42
1169,484,"Gas Service",2,35,70,7,77
1170,485,"Flooring Service",10,24,240,24,264
1171,485,"Electricity Service",5,43,215,22,237
1172,486,"Gas Service",3,50,150,15,165
1173,486,"Electricity Service",8,47,376,38,414
1174,487,"Electricity Service",8,50,400,40,440
1175,487,"Flooring Service",2,11,22,2,24
1176,488,"Flooring Service",4,42,168,17,185
1177,488,"Electricity Service",3,35,105,11,116
1178,489,"Gas Service",3,42,126,13,139
1179,489,"Flooring Service",6,24,144,14,158
1180,490,"Gas Service",5,10,50,5,55
1181,490,"Electricity Service",1,50,50,5,55
1182,491,"Gas Service",7,17,119,12,131
1183,491,"AC Maintenance Service",5,17,85,9,94
1184,492,"Flooring Service",9,46,414,41,455
1185,492,"Flooring Service",10,33,330,33,363
1186,493,"AC Maintenance Service",3,16,48,5,53
1187,493,"Flooring Service",6,29,174,17,191
1188,494,"Electricity Service",4,22,88,9,97
1189,494,"Window Cleaning Service",3,32,96,10,106
1190,495,"Window Cleaning Service",10,46,460,46,506
1191,495,"Window Cleaning Service",7,31,217,22,239
1192,496,"AC Maintenance Service",10,16,160,16,176
1193,496,"AC Maintenance Service",4,24,96,10,106
1194,497,"Plumber Service",2,43,86,9,95
1195,497,"Window Cleaning Service",7,46,322,32,354
1196,498,"Gas Service",7,32,224,22,246
1197,498,"Plumber Service",5,44,220,22,242
1198,499,"AC Maintenance Service",4,12,48,5,53
1199,499,"Gas Service",9,21,189,19,208
1200,500,"Window Cleaning Service",10,16,160,16,176
1201,500,"Window Cleaning Service",7,28,196,20,216
1202,501,"AC Maintenance Service",2,48,96,10,106
1203,501,"Window Cleaning Service",10,16,160,16,176
1204,502,"Plumber Service",9,46,414,41,455
1205,502,"Plumber Service",3,50,150,15,165
1206,503,"Electricity Service",3,11,33,3,36
1207,503,"Window Cleaning Service",4,43,172,17,189
1208,504,"AC Maintenance Service",3,48,144,14,158
1209,504,"Gas Service",8,35,280,28,308
1210,505,"Flooring Service",1,39,39,4,43
1211,505,"Gas Service",7,35,245,25,270
1212,506,"AC Maintenance Service",1,18,18,2,20
1213,506,"Window Cleaning Service",5,14,70,7,77
1214,507,"Electricity Service",1,33,33,3,36
1215,507,"Plumber Service",9,25,225,23,248
1216,508,"Window Cleaning Service",7,47,329,33,362
1217,508,"Gas Service",1,32,32,3,35
1218,509,"AC Maintenance Service",1,16,16,2,18
1219,509,"Flooring Service",7,33,231,23,254
1220,510,"Electricity Service",6,18,108,11,119
1221,510,"AC Maintenance Service",9,46,414,41,455
1222,511,"AC Maintenance Service",7,22,154,15,169
1223,511,"Flooring Service",7,39,273,27,300
1224,512,"Plumber Service",3,11,33,3,36
1225,512,"Electricity Service",3,47,141,14,155
1226,513,"Electricity Service",1,18,18,2,20
1227,513,"Window Cleaning Service",4,29,116,12,128
1228,514,"Plumber Service",7,17,119,12,131
1229,514,"Plumber Service",7,29,203,20,223
1230,515,"Electricity Service",9,34,306,31,337
1231,515,"AC Maintenance Service",9,44,396,40,436
1232,516,"Electricity Service",4,11,44,4,48
1233,516,"Electricity Service",7,36,252,25,277
1234,517,"Window Cleaning Service",9,41,369,37,406
1235,517,"Electricity Service",10,24,240,24,264
1236,518,"Window Cleaning Service",4,50,200,20,220
1237,518,"Flooring Service",1,26,26,3,29
1238,519,"Gas Service",8,20,160,16,176
1239,519,"AC Maintenance Service",1,12,12,1,13
1240,520,"AC Maintenance Service",2,34,68,7,75
1241,520,"Electricity Service",2,24,48,5,53
1242,521,"Electricity Service",9,39,351,35,386
1243,521,"Plumber Service",8,33,264,26,290
1244,522,"Gas Service",1,48,48,5,53
1245,522,"Window Cleaning Service",2,30,60,6,66
1246,523,"Gas Service",8,37,296,30,326
1247,523,"Plumber Service",7,29,203,20,223
1248,524,"Electricity Service",10,41,410,41,451
1249,524,"Flooring Service",10,29,290,29,319
1250,525,"Gas Service",7,10,70,7,77
1251,525,"Gas Service",5,42,210,21,231
1252,526,"AC Maintenance Service",8,32,256,26,282
1253,526,"Electricity Service",7,19,133,13,146
1254,527,"AC Maintenance Service",6,39,234,23,257
1255,527,"AC Maintenance Service",1,31,31,3,34
1256,528,"Flooring Service",1,37,37,4,41
1257,528,"Electricity Service",4,23,92,9,101
1258,529,"Gas Service",10,21,210,21,231
1259,529,"Flooring Service",1,30,30,3,33
1260,530,"Window Cleaning Service",3,20,60,6,66
1261,530,"Flooring Service",2,38,76,8,84
1262,531,"Window Cleaning Service",3,36,108,11,119
1263,531,"Gas Service",6,22,132,13,145
1264,532,"Window Cleaning Service",6,29,174,17,191
1265,532,"Plumber Service",2,23,46,5,51
1266,533,"Gas Service",1,18,18,2,20
1267,533,"Electricity Service",5,23,115,12,127
1268,534,"Flooring Service",8,12,96,10,106
1269,534,"Gas Service",4,14,56,6,62
1270,535,"Flooring Service",9,44,396,40,436
1271,535,"Gas Service",1,18,18,2,20
1272,536,"Flooring Service",6,47,282,28,310
1273,536,"Window Cleaning Service",3,33,99,10,109
1274,537,"Gas Service",2,34,68,7,75
1275,537,"Plumber Service",1,11,11,1,12
1276,538,"Gas Service",3,11,33,3,36
1277,538,"Flooring Service",9,13,117,12,129
1278,539,"Window Cleaning Service",5,48,240,24,264
1279,539,"Plumber Service",8,47,376,38,414
1280,540,"AC Maintenance Service",7,35,245,25,270
1281,540,"Flooring Service",3,36,108,11,119
1282,541,"AC Maintenance Service",6,25,150,15,165
1283,541,"AC Maintenance Service",7,39,273,27,300
1284,542,"AC Maintenance Service",5,48,240,24,264
1285,542,"Gas Service",5,31,155,16,171
1286,543,"Plumber Service",10,30,300,30,330
1287,543,"Electricity Service",10,49,490,49,539
1288,544,"Electricity Service",7,15,105,11,116
1289,544,"Window Cleaning Service",4,20,80,8,88
1290,545,"Window Cleaning Service",7,43,301,30,331
1291,545,"Flooring Service",4,34,136,14,150
1292,546,"Window Cleaning Service",4,44,176,18,194
1293,546,"Window Cleaning Service",8,23,184,18,202
1294,547,"Plumber Service",9,16,144,14,158
1295,547,"Electricity Service",9,41,369,37,406
1296,548,"Window Cleaning Service",2,42,84,8,92
1297,548,"Flooring Service",2,31,62,6,68
1298,549,"Window Cleaning Service",2,33,66,7,73
1299,549,"Window Cleaning Service",6,30,180,18,198
1300,550,"Electricity Service",1,21,21,2,23
1301,550,"Plumber Service",4,35,140,14,154
1302,551,"AC Maintenance Service",2,11,22,2,24
1303,551,"Window Cleaning Service",6,33,198,20,218
1304,552,"Flooring Service",8,19,152,15,167
1305,552,"Window Cleaning Service",5,27,135,14,149
1306,553,"Plumber Service",8,10,80,8,88
1307,553,"Plumber Service",7,34,238,24,262
1308,554,"Plumber Service",6,10,60,6,66
1309,554,"AC Maintenance Service",5,43,215,22,237
1310,555,"Electricity Service",1,22,22,2,24
1311,555,"Gas Service",3,30,90,9,99
1312,556,"Plumber Service",6,46,276,28,304
1313,556,"Flooring Service",4,24,96,10,106
1314,557,"Plumber Service",8,39,312,31,343
1315,557,"Flooring Service",1,17,17,2,19
1316,558,"AC Maintenance Service",4,36,144,14,158
1317,558,"Gas Service",2,32,64,6,70
1318,559,"Flooring Service",9,26,234,23,257
1319,559,"Flooring Service",7,44,308,31,339
1320,560,"Window Cleaning Service",5,47,235,24,259
1321,560,"AC Maintenance Service",3,31,93,9,102
1322,561,"Plumber Service",1,11,11,1,12
1323,561,"Flooring Service",8,28,224,22,246
1324,562,"Electricity Service",8,50,400,40,440
1325,562,"Electricity Service",7,48,336,34,370
1326,563,"Flooring Service",6,46,276,28,304
1327,563,"Gas Service",1,29,29,3,32
1328,564,"Window Cleaning Service",4,50,200,20,220
1329,564,"Plumber Service",7,42,294,29,323
1330,565,"Plumber Service",2,19,38,4,42
1331,565,"Window Cleaning Service",3,14,42,4,46
1332,566,"Plumber Service",9,40,360,36,396
1333,566,"Electricity Service",9,38,342,34,376
1334,567,"Gas Service",7,40,280,28,308
1335,567,"Gas Service",6,35,210,21,231
1336,568,"Flooring Service",6,20,120,12,132
1337,568,"Electricity Service",9,20,180,18,198
1338,569,"Window Cleaning Service",1,38,38,4,42
1339,569,"Plumber Service",2,34,68,7,75
1340,570,"Electricity Service",9,23,207,21,228
1341,570,"Gas Service",1,13,13,1,14
1342,571,"Flooring Service",6,43,258,26,284
1343,571,"Plumber Service",6,26,156,16,172
1344,572,"Flooring Service",2,19,38,4,42
1345,572,"Gas Service",2,25,50,5,55
1346,573,"AC Maintenance Service",8,10,80,8,88
1347,573,"Window Cleaning Service",2,13,26,3,29
1348,574,"Electricity Service",6,41,246,25,271
1349,574,"Flooring Service",6,33,198,20,218
1350,575,"Electricity Service",1,14,14,1,15
1351,575,"Plumber Service",3,21,63,6,69
1352,576,"Gas Service",8,37,296,30,326
1353,576,"Plumber Service",6,43,258,26,284
1354,577,"AC Maintenance Service",1,18,18,2,20
1355,577,"Gas Service",7,12,84,8,92
1356,578,"AC Maintenance Service",7,22,154,15,169
1357,578,"AC Maintenance Service",1,41,41,4,45
1358,579,"Flooring Service",6,19,114,11,125
1359,579,"AC Maintenance Service",5,48,240,24,264
1360,580,"Plumber Service",2,40,80,8,88
1361,580,"AC Maintenance Service",6,12,72,7,79
1362,581,"Electricity Service",10,14,140,14,154
1363,581,"AC Maintenance Service",5,26,130,13,143
1364,582,"Window Cleaning Service",8,23,184,18,202
1365,582,"Window Cleaning Service",2,48,96,10,106
1366,583,"Gas Service",6,10,60,6,66
1367,583,"Plumber Service",1,35,35,4,39
1368,584,"Electricity Service",8,17,136,14,150
1369,584,"Plumber Service",5,32,160,16,176
1370,585,"Flooring Service",6,48,288,29,317
1371,585,"Plumber Service",4,23,92,9,101
1372,586,"Plumber Service",9,31,279,28,307
1373,586,"Gas Service",5,42,210,21,231
1374,587,"Window Cleaning Service",1,41,41,4,45
1375,587,"Electricity Service",1,14,14,1,15
1376,588,"Electricity Service",2,25,50,5,55
1377,588,"Plumber Service",4,23,92,9,101
1378,589,"Flooring Service",7,11,77,8,85
1379,589,"Window Cleaning Service",2,10,20,2,22
1380,590,"AC Maintenance Service",7,29,203,20,223
1381,590,"Window Cleaning Service",7,26,182,18,200
1382,591,"Flooring Service",7,42,294,29,323
1383,591,"Window Cleaning Service",4,10,40,4,44
1384,592,"Plumber Service",2,48,96,10,106
1385,592,"Gas Service",9,31,279,28,307
1386,593,"Gas Service",9,48,432,43,475
1387,593,"Flooring Service",5,49,245,25,270
1388,594,"Flooring Service",7,20,140,14,154
1389,594,"Plumber Service",3,45,135,14,149
1390,595,"Flooring Service",5,49,245,25,270
1391,595,"Plumber Service",5,28,140,14,154
1392,596,"Electricity Service",7,23,161,16,177
1393,596,"Electricity Service",7,49,343,34,377
1394,597,"Gas Service",8,27,216,22,238
1395,597,"Window Cleaning Service",9,31,279,28,307
1396,598,"Gas Service",7,15,105,11,116
1397,598,"Flooring Service",6,23,138,14,152
1398,599,"Flooring Service",4,47,188,19,207
1399,599,"Flooring Service",8,12,96,10,106
1400,600,"Plumber Service",6,46,276,28,304
1401,600,"Electricity Service",4,45,180,18,198
1402,601,"Plumber Service",9,10,90,9,99
1403,601,"Window Cleaning Service",7,24,168,17,185
1404,602,"Plumber Service",9,46,414,41,455
1405,602,"Gas Service",5,11,55,6,61
1406,603,"Gas Service",5,14,70,7,77
1407,603,"Flooring Service",5,29,145,15,160
1408,604,"Flooring Service",3,35,105,11,116
1409,604,"Gas Service",6,18,108,11,119
1410,605,"AC Maintenance Service",6,28,168,17,185
1411,605,"Gas Service",4,24,96,10,106
1412,606,"Window Cleaning Service",4,20,80,8,88
1413,606,"AC Maintenance Service",5,48,240,24,264
1414,607,"Plumber Service",3,35,105,11,116
1415,607,"Gas Service",10,47,470,47,517
1416,608,"Window Cleaning Service",1,39,39,4,43
1417,608,"Gas Service",5,49,245,25,270
1418,609,"Gas Service",10,26,260,26,286
1419,609,"Gas Service",1,24,24,2,26
1420,610,"Gas Service",6,13,78,8,86
1421,610,"AC Maintenance Service",8,23,184,18,202
1422,611,"Gas Service",4,38,152,15,167
1423,611,"Flooring Service",8,45,360,36,396
1424,612,"Gas Service",2,44,88,9,97
1425,612,"Gas Service",5,49,245,25,270
1426,613,"Flooring Service",9,50,450,45,495
1427,613,"Gas Service",1,29,29,3,32
1428,614,"Window Cleaning Service",10,24,240,24,264
1429,614,"Electricity Service",3,47,141,14,155
1430,615,"Plumber Service",7,11,77,8,85
1431,615,"Plumber Service",1,49,49,5,54
1432,616,"Electricity Service",8,44,352,35,387
1433,616,"Window Cleaning Service",7,12,84,8,92
1434,617,"Flooring Service",5,12,60,6,66
1435,617,"Window Cleaning Service",1,32,32,3,35
1436,618,"AC Maintenance Service",10,21,210,21,231
1437,618,"AC Maintenance Service",9,38,342,34,376
1438,619,"Plumber Service",5,31,155,16,171
1439,619,"Window Cleaning Service",9,50,450,45,495
1440,620,"Window Cleaning Service",6,38,228,23,251
1441,620,"Plumber Service",2,33,66,7,73
1442,621,"Electricity Service",5,27,135,14,149
1443,621,"Flooring Service",8,41,328,33,361
1444,622,"Electricity Service",4,49,196,20,216
1445,622,"Electricity Service",3,48,144,14,158
1446,623,"Flooring Service",3,11,33,3,36
1447,623,"Electricity Service",6,19,114,11,125
1448,624,"Flooring Service",10,45,450,45,495
1449,624,"AC Maintenance Service",9,46,414,41,455
1450,625,"Window Cleaning Service",3,35,105,11,116
1451,625,"Window Cleaning Service",10,15,150,15,165
1452,626,"AC Maintenance Service",1,42,42,4,46
1453,626,"Plumber Service",8,22,176,18,194
1454,627,"Gas Service",8,25,200,20,220
1455,627,"Flooring Service",5,29,145,15,160
1456,628,"Electricity Service",7,27,189,19,208
1457,628,"Gas Service",3,46,138,14,152
1458,629,"Electricity Service",10,47,470,47,517
1459,629,"Plumber Service",4,39,156,16,172
1460,630,"Plumber Service",9,24,216,22,238
1461,630,"Window Cleaning Service",1,31,31,3,34
1462,631,"AC Maintenance Service",4,12,48,5,53
1463,631,"AC Maintenance Service",3,39,117,12,129
1464,632,"Window Cleaning Service",4,32,128,13,141
1465,632,"AC Maintenance Service",5,16,80,8,88
1466,633,"AC Maintenance Service",9,41,369,37,406
1467,633,"Window Cleaning Service",10,40,400,40,440
1468,634,"Electricity Service",9,32,288,29,317
1469,634,"AC Maintenance Service",10,34,340,34,374
1470,635,"Gas Service",6,43,258,26,284
1471,635,"Window Cleaning Service",1,42,42,4,46
1472,636,"Window Cleaning Service",2,40,80,8,88
1473,636,"Electricity Service",3,35,105,11,116
1474,637,"AC Maintenance Service",2,29,58,6,64
1475,637,"Gas Service",4,22,88,9,97
1476,638,"Flooring Service",5,33,165,17,182
1477,638,"Gas Service",2,32,64,6,70
1478,639,"Flooring Service",4,34,136,14,150
1479,639,"Window Cleaning Service",7,27,189,19,208
1480,640,"Window Cleaning Service",5,41,205,21,226
1481,640,"Gas Service",3,23,69,7,76
1482,641,"Flooring Service",9,11,99,10,109
1483,641,"Flooring Service",5,25,125,13,138
1484,642,"AC Maintenance Service",4,26,104,10,114
1485,642,"Plumber Service",6,43,258,26,284
1486,643,"AC Maintenance Service",9,27,243,24,267
1487,643,"Flooring Service",7,33,231,23,254
1488,644,"Plumber Service",4,40,160,16,176
1489,644,"Flooring Service",8,32,256,26,282
1490,645,"Window Cleaning Service",5,11,55,6,61
1491,645,"Window Cleaning Service",2,12,24,2,26
1492,646,"Plumber Service",3,50,150,15,165
1493,646,"Electricity Service",5,13,65,7,72
1494,647,"Window Cleaning Service",9,33,297,30,327
1495,647,"Plumber Service",10,32,320,32,352
1496,648,"Window Cleaning Service",9,33,297,30,327
1497,648,"Flooring Service",2,43,86,9,95
1498,649,"Flooring Service",7,42,294,29,323
1499,649,"AC Maintenance Service",3,46,138,14,152
1500,650,"Window Cleaning Service",5,15,75,8,83
1501,650,"Flooring Service",4,24,96,10,106
1502,651,"Flooring Service",7,44,308,31,339
1503,651,"Window Cleaning Service",5,23,115,12,127
1504,652,"Flooring Service",4,29,116,12,128
1505,652,"Gas Service",4,49,196,20,216
1506,653,"Window Cleaning Service",1,46,46,5,51
1507,653,"Window Cleaning Service",6,36,216,22,238
1508,654,"Window Cleaning Service",1,16,16,2,18
1509,654,"Gas Service",8,17,136,14,150
1510,655,"Electricity Service",5,31,155,16,171
1511,655,"Plumber Service",3,49,147,15,162
1512,656,"Flooring Service",7,22,154,15,169
1513,656,"Electricity Service",7,49,343,34,377
1514,657,"Electricity Service",3,32,96,10,106
1515,657,"Window Cleaning Service",9,25,225,23,248
1516,658,"Flooring Service",9,30,270,27,297
1517,658,"AC Maintenance Service",5,39,195,20,215
1518,659,"Electricity Service",5,15,75,8,83
1519,659,"Flooring Service",3,40,120,12,132
1520,660,"AC Maintenance Service",3,12,36,4,40
1521,660,"Flooring Service",6,33,198,20,218
1522,661,"Gas Service",5,12,60,6,66
1523,661,"Flooring Service",4,50,200,20,220
1524,662,"Electricity Service",1,35,35,4,39
1525,662,"AC Maintenance Service",3,46,138,14,152
1526,663,"Flooring Service",5,38,190,19,209
1527,663,"Flooring Service",3,25,75,8,83
1528,664,"Flooring Service",2,13,26,3,29
1529,664,"Gas Service",6,24,144,14,158
1530,665,"Electricity Service",6,33,198,20,218
1531,665,"Plumber Service",1,38,38,4,42
1532,666,"AC Maintenance Service",6,49,294,29,323
1533,666,"Gas Service",9,13,117,12,129
1534,667,"AC Maintenance Service",3,40,120,12,132
1535,667,"Plumber Service",2,35,70,7,77
1536,668,"Window Cleaning Service",2,34,68,7,75
1537,668,"Flooring Service",6,11,66,7,73
1538,669,"AC Maintenance Service",9,40,360,36,396
1539,669,"AC Maintenance Service",2,20,40,4,44
1540,670,"Flooring Service",10,36,360,36,396
1541,670,"Gas Service",8,22,176,18,194
1542,671,"Window Cleaning Service",2,14,28,3,31
1543,671,"Gas Service",4,20,80,8,88
1544,672,"AC Maintenance Service",1,10,10,1,11
1545,672,"AC Maintenance Service",9,15,135,14,149
1546,673,"Window Cleaning Service",1,41,41,4,45
1547,673,"Gas Service",5,49,245,25,270
1548,674,"Flooring Service",3,37,111,11,122
1549,674,"AC Maintenance Service",2,14,28,3,31
1550,675,"Window Cleaning Service",7,27,189,19,208
1551,675,"Flooring Service",7,21,147,15,162
1552,676,"Window Cleaning Service",7,15,105,11,116
1553,676,"Window Cleaning Service",3,20,60,6,66
1554,677,"Window Cleaning Service",8,34,272,27,299
1555,677,"Electricity Service",3,39,117,12,129
1556,678,"Gas Service",3,14,42,4,46
1557,678,"Gas Service",2,39,78,8,86
1558,679,"Electricity Service",3,11,33,3,36
1559,679,"Electricity Service",1,12,12,1,13
1560,680,"Window Cleaning Service",5,17,85,9,94
1561,680,"Window Cleaning Service",1,21,21,2,23
1562,681,"Electricity Service",8,20,160,16,176
1563,681,"Flooring Service",6,39,234,23,257
1564,682,"Flooring Service",9,22,198,20,218
1565,682,"Window Cleaning Service",7,18,126,13,139
1566,683,"Plumber Service",8,13,104,10,114
1567,683,"Window Cleaning Service",8,27,216,22,238
1568,684,"Electricity Service",7,21,147,15,162
1569,684,"Flooring Service",1,49,49,5,54
1570,685,"Flooring Service",2,21,42,4,46
1571,685,"AC Maintenance Service",4,28,112,11,123
1572,686,"Window Cleaning Service",9,39,351,35,386
1573,686,"Window Cleaning Service",7,41,287,29,316
1574,687,"Flooring Service",1,44,44,4,48
1575,687,"Window Cleaning Service",1,17,17,2,19
1576,688,"Electricity Service",10,12,120,12,132
1577,688,"Plumber Service",9,37,333,33,366
1578,689,"Window Cleaning Service",1,40,40,4,44
1579,689,"Plumber Service",1,22,22,2,24
1580,690,"AC Maintenance Service",4,28,112,11,123
1581,690,"Gas Service",10,41,410,41,451
1582,691,"Electricity Service",10,48,480,48,528
1583,691,"AC Maintenance Service",8,41,328,33,361
1584,692,"AC Maintenance Service",10,41,410,41,451
1585,692,"Window Cleaning Service",9,30,270,27,297
1586,693,"Electricity Service",6,41,246,25,271
1587,693,"Gas Service",2,39,78,8,86
1588,694,"Plumber Service",9,44,396,40,436
1589,694,"Gas Service",7,37,259,26,285
1590,695,"Plumber Service",6,32,192,19,211
1591,695,"AC Maintenance Service",5,22,110,11,121
1592,696,"Flooring Service",2,10,20,2,22
1593,696,"Gas Service",8,10,80,8,88
1594,697,"Window Cleaning Service",8,38,304,30,334
1595,697,"Gas Service",6,14,84,8,92
1596,698,"Electricity Service",8,43,344,34,378
1597,698,"Electricity Service",5,45,225,23,248
1598,699,"Plumber Service",10,37,370,37,407
1599,699,"AC Maintenance Service",2,11,22,2,24
1600,700,"Electricity Service",10,47,470,47,517
1601,700,"Window Cleaning Service",10,25,250,25,275
1602,701,"Gas Service",5,16,80,8,88
1603,701,"Electricity Service",4,48,192,19,211
1604,702,"Flooring Service",2,20,40,4,44
1605,702,"Electricity Service",5,20,100,10,110
1606,703,"AC Maintenance Service",8,15,120,12,132
1607,703,"AC Maintenance Service",4,27,108,11,119
1608,704,"Plumber Service",3,29,87,9,96
1609,704,"Electricity Service",3,26,78,8,86
1610,705,"Electricity Service",10,42,420,42,462
1611,705,"Plumber Service",6,28,168,17,185
1612,706,"Gas Service",4,28,112,11,123
1613,706,"Window Cleaning Service",6,23,138,14,152
1614,707,"Flooring Service",5,20,100,10,110
1615,707,"Plumber Service",5,50,250,25,275
1616,708,"AC Maintenance Service",5,11,55,6,61
1617,708,"Plumber Service",4,20,80,8,88
1618,709,"Plumber Service",7,36,252,25,277
1619,709,"Window Cleaning Service",5,28,140,14,154
1620,710,"Window Cleaning Service",1,37,37,4,41
1621,710,"Electricity Service",1,40,40,4,44
1622,711,"Electricity Service",10,44,440,44,484
1623,711,"Plumber Service",1,19,19,2,21
1624,712,"Window Cleaning Service",1,39,39,4,43
1625,712,"Gas Service",5,16,80,8,88
1626,713,"Window Cleaning Service",6,21,126,13,139
1627,713,"Gas Service",8,42,336,34,370
1628,714,"Plumber Service",7,41,287,29,316
1629,714,"Flooring Service",5,34,170,17,187
1630,715,"AC Maintenance Service",7,14,98,10,108
1631,715,"Flooring Service",2,15,30,3,33
1632,716,"Electricity Service",6,45,270,27,297
1633,716,"Plumber Service",4,38,152,15,167
1634,717,"Electricity Service",10,25,250,25,275
1635,717,"Electricity Service",1,34,34,3,37
1636,718,"Window Cleaning Service",7,32,224,22,246
1637,718,"Plumber Service",2,11,22,2,24
1638,719,"Electricity Service",9,47,423,42,465
1639,719,"Window Cleaning Service",5,28,140,14,154
1640,720,"AC Maintenance Service",6,26,156,16,172
1641,720,"Window Cleaning Service",5,19,95,10,105
1642,721,"Gas Service",10,12,120,12,132
1643,721,"Flooring Service",3,37,111,11,122
1644,722,"AC Maintenance Service",4,22,88,9,97
1645,722,"Flooring Service",5,10,50,5,55
1646,723,"Plumber Service",9,25,225,23,248
1647,723,"AC Maintenance Service",10,38,380,38,418
1648,724,"Window Cleaning Service",8,20,160,16,176
1649,724,"Gas Service",8,44,352,35,387
1650,725,"Electricity Service",5,24,120,12,132
1651,725,"Gas Service",2,31,62,6,68
1652,726,"Electricity Service",7,32,224,22,246
1653,726,"Electricity Service",6,50,300,30,330
1654,727,"Electricity Service",4,21,84,8,92
1655,727,"Gas Service",7,36,252,25,277
1656,728,"Plumber Service",7,50,350,35,385
1657,728,"Gas Service",6,31,186,19,205
1658,729,"Electricity Service",5,23,115,12,127
1659,729,"Window Cleaning Service",5,31,155,16,171
1660,730,"Plumber Service",5,30,150,15,165
1661,730,"Plumber Service",10,21,210,21,231
1662,731,"Electricity Service",2,40,80,8,88
1663,731,"Plumber Service",8,18,144,14,158
1664,732,"Gas Service",1,50,50,5,55
1665,732,"Window Cleaning Service",7,38,266,27,293
1666,733,"AC Maintenance Service",5,37,185,19,204
1667,733,"Flooring Service",2,28,56,6,62
1668,734,"AC Maintenance Service",2,19,38,4,42
1669,734,"Gas Service",9,47,423,42,465
1670,735,"Electricity Service",8,23,184,18,202
1671,735,"Plumber Service",2,23,46,5,51
1672,736,"Gas Service",4,45,180,18,198
1673,736,"AC Maintenance Service",10,29,290,29,319
1674,737,"Gas Service",4,21,84,8,92
1675,737,"AC Maintenance Service",7,36,252,25,277
1676,738,"Flooring Service",7,35,245,25,270
1677,738,"AC Maintenance Service",2,19,38,4,42
1678,739,"Electricity Service",8,15,120,12,132
1679,739,"Window Cleaning Service",6,37,222,22,244
1680,740,"Plumber Service",4,24,96,10,106
1681,740,"Electricity Service",6,10,60,6,66
1682,741,"AC Maintenance Service",7,20,140,14,154
1683,741,"AC Maintenance Service",3,38,114,11,125
1684,742,"Plumber Service",3,10,30,3,33
1685,742,"Electricity Service",5,42,210,21,231
1686,743,"Gas Service",9,30,270,27,297
1687,743,"Electricity Service",10,25,250,25,275
1688,744,"Electricity Service",8,45,360,36,396
1689,744,"Gas Service",8,19,152,15,167
1690,745,"Window Cleaning Service",2,41,82,8,90
1691,745,"AC Maintenance Service",9,18,162,16,178
1692,746,"AC Maintenance Service",8,10,80,8,88
1693,746,"AC Maintenance Service",1,23,23,2,25
1694,747,"Window Cleaning Service",5,20,100,10,110
1695,747,"Window Cleaning Service",4,13,52,5,57
1696,748,"Flooring Service",5,23,115,12,127
1697,748,"AC Maintenance Service",8,38,304,30,334
1698,749,"Flooring Service",2,28,56,6,62
1699,749,"Flooring Service",4,50,200,20,220
1700,750,"Gas Service",9,46,414,41,455
1701,750,"AC Maintenance Service",4,31,124,12,136
1702,751,"AC Maintenance Service",3,43,129,13,142
1703,751,"Electricity Service",2,39,78,8,86
1704,752,"Gas Service",6,28,168,17,185
1705,752,"Window Cleaning Service",5,36,180,18,198
1706,753,"Plumber Service",10,42,420,42,462
1707,753,"Window Cleaning Service",8,40,320,32,352
1708,754,"Gas Service",2,34,68,7,75
1709,754,"Electricity Service",8,21,168,17,185
1710,755,"Window Cleaning Service",9,14,126,13,139
1711,755,"Window Cleaning Service",10,34,340,34,374
1712,756,"Window Cleaning Service",7,10,70,7,77
1713,756,"Flooring Service",8,29,232,23,255
1714,757,"Flooring Service",10,48,480,48,528
1715,757,"Window Cleaning Service",7,12,84,8,92
1716,758,"Electricity Service",6,43,258,26,284
1717,758,"Electricity Service",3,44,132,13,145
1718,759,"Electricity Service",9,22,198,20,218
1719,759,"Gas Service",9,10,90,9,99
1720,760,"Gas Service",8,19,152,15,167
1721,760,"AC Maintenance Service",4,21,84,8,92
1722,761,"AC Maintenance Service",3,41,123,12,135
1723,761,"Window Cleaning Service",9,40,360,36,396
1724,762,"Electricity Service",6,11,66,7,73
1725,762,"AC Maintenance Service",2,33,66,7,73
1726,763,"AC Maintenance Service",3,16,48,5,53
1727,763,"Flooring Service",8,43,344,34,378
1728,764,"Window Cleaning Service",3,10,30,3,33
1729,764,"Electricity Service",1,49,49,5,54
1730,765,"Window Cleaning Service",5,46,230,23,253
1731,765,"Electricity Service",8,19,152,15,167
1732,766,"Electricity Service",7,25,175,18,193
1733,766,"Electricity Service",1,11,11,1,12
1734,767,"Flooring Service",8,33,264,26,290
1735,767,"Electricity Service",9,41,369,37,406
1736,768,"Gas Service",9,21,189,19,208
1737,768,"Electricity Service",4,16,64,6,70
1738,769,"Electricity Service",4,23,92,9,101
1739,769,"Window Cleaning Service",2,22,44,4,48
1740,770,"AC Maintenance Service",7,12,84,8,92
1741,770,"Electricity Service",6,40,240,24,264
1742,771,"Electricity Service",6,34,204,20,224
1743,771,"Flooring Service",8,32,256,26,282
1744,772,"AC Maintenance Service",9,37,333,33,366
1745,772,"Plumber Service",9,41,369,37,406
1746,773,"Plumber Service",3,25,75,8,83
1747,773,"Electricity Service",7,18,126,13,139
1748,774,"Flooring Service",7,21,147,15,162
1749,774,"Gas Service",5,34,170,17,187
1750,775,"AC Maintenance Service",8,48,384,38,422
1751,775,"Gas Service",3,15,45,5,50
1752,776,"Electricity Service",4,47,188,19,207
1753,776,"Flooring Service",10,22,220,22,242
1754,777,"Electricity Service",1,17,17,2,19
1755,777,"Electricity Service",5,41,205,21,226
1756,778,"Plumber Service",4,20,80,8,88
1757,778,"Window Cleaning Service",3,37,111,11,122
1758,779,"Flooring Service",2,16,32,3,35
1759,779,"Gas Service",7,41,287,29,316
1760,780,"Flooring Service",5,11,55,6,61
1761,780,"Plumber Service",1,18,18,2,20
1762,781,"Window Cleaning Service",7,18,126,13,139
1763,781,"Plumber Service",1,39,39,4,43
1764,782,"Window Cleaning Service",4,44,176,18,194
1765,782,"Electricity Service",5,11,55,6,61
1766,783,"Flooring Service",10,34,340,34,374
1767,783,"Electricity Service",9,48,432,43,475
1768,784,"Window Cleaning Service",3,21,63,6,69
1769,784,"Gas Service",4,31,124,12,136
1770,785,"Plumber Service",1,34,34,3,37
1771,785,"AC Maintenance Service",2,14,28,3,31
1772,786,"Window Cleaning Service",4,15,60,6,66
1773,786,"Electricity Service",7,18,126,13,139
1774,787,"Window Cleaning Service",1,36,36,4,40
1775,787,"Flooring Service",5,33,165,17,182
1776,788,"Flooring Service",9,21,189,19,208
1777,788,"Window Cleaning Service",7,21,147,15,162
1778,789,"Plumber Service",3,15,45,5,50
1779,789,"Plumber Service",2,38,76,8,84
1780,790,"Plumber Service",10,23,230,23,253
1781,790,"AC Maintenance Service",9,28,252,25,277
1782,791,"Electricity Service",4,17,68,7,75
1783,791,"AC Maintenance Service",5,49,245,25,270
1784,792,"Flooring Service",5,18,90,9,99
1785,792,"Window Cleaning Service",9,30,270,27,297
1786,793,"Gas Service",5,17,85,9,94
1787,793,"Flooring Service",4,33,132,13,145
1788,794,"AC Maintenance Service",3,19,57,6,63
1789,794,"Plumber Service",9,18,162,16,178
1790,795,"Gas Service",9,36,324,32,356
1791,795,"Window Cleaning Service",6,37,222,22,244
1792,796,"Plumber Service",9,35,315,32,347
1793,796,"Flooring Service",10,49,490,49,539
1794,797,"Electricity Service",7,17,119,12,131
1795,797,"Window Cleaning Service",10,31,310,31,341
1796,798,"Gas Service",6,16,96,10,106
1797,798,"Flooring Service",10,13,130,13,143
1798,799,"Window Cleaning Service",5,15,75,8,83
1799,799,"Flooring Service",6,50,300,30,330
1800,800,"Window Cleaning Service",1,43,43,4,47
1801,800,"Flooring Service",2,18,36,4,40
1802,801,"Gas Service",9,47,423,42,465
1803,801,"Electricity Service",9,37,333,33,366
1804,802,"Flooring Service",1,39,39,4,43
1805,802,"Electricity Service",3,14,42,4,46
1806,803,"Plumber Service",7,50,350,35,385
1807,803,"Window Cleaning Service",4,18,72,7,79
1808,804,"Electricity Service",9,45,405,41,446
1809,804,"Plumber Service",9,39,351,35,386
1810,805,"AC Maintenance Service",3,11,33,3,36
1811,805,"AC Maintenance Service",9,30,270,27,297
1812,806,"Window Cleaning Service",4,42,168,17,185
1813,806,"AC Maintenance Service",4,28,112,11,123
1814,807,"AC Maintenance Service",8,37,296,30,326
1815,807,"Flooring Service",5,14,70,7,77
1816,808,"AC Maintenance Service",7,45,315,32,347
1817,808,"AC Maintenance Service",8,19,152,15,167
1818,809,"Window Cleaning Service",9,26,234,23,257
1819,809,"Flooring Service",1,28,28,3,31
1820,810,"Plumber Service",6,42,252,25,277
1821,810,"Gas Service",5,44,220,22,242
1822,811,"Gas Service",9,31,279,28,307
1823,811,"Plumber Service",6,49,294,29,323
1824,812,"Plumber Service",6,31,186,19,205
1825,812,"Window Cleaning Service",10,21,210,21,231
1826,813,"Flooring Service",9,25,225,23,248
1827,813,"Electricity Service",8,20,160,16,176
1828,814,"Flooring Service",7,14,98,10,108
1829,814,"Gas Service",6,36,216,22,238
1830,815,"Flooring Service",2,43,86,9,95
1831,815,"Flooring Service",1,31,31,3,34
1832,816,"Flooring Service",7,42,294,29,323
1833,816,"AC Maintenance Service",4,33,132,13,145
1834,817,"Window Cleaning Service",1,42,42,4,46
1835,817,"Window Cleaning Service",7,15,105,11,116
1836,818,"Flooring Service",8,33,264,26,290
1837,818,"Electricity Service",9,16,144,14,158
1838,819,"Gas Service",3,29,87,9,96
1839,819,"AC Maintenance Service",9,11,99,10,109
1840,820,"AC Maintenance Service",2,28,56,6,62
1841,820,"Gas Service",5,38,190,19,209
1842,821,"Plumber Service",9,30,270,27,297
1843,821,"Flooring Service",1,35,35,4,39
1844,822,"Plumber Service",5,10,50,5,55
1845,822,"Gas Service",8,33,264,26,290
1846,823,"Electricity Service",6,39,234,23,257
1847,823,"Gas Service",3,49,147,15,162
1848,824,"AC Maintenance Service",9,41,369,37,406
1849,824,"AC Maintenance Service",6,15,90,9,99
1850,825,"Window Cleaning Service",4,21,84,8,92
1851,825,"Gas Service",3,50,150,15,165
1852,826,"AC Maintenance Service",7,44,308,31,339
1853,826,"Electricity Service",4,23,92,9,101
1854,827,"Plumber Service",5,24,120,12,132
1855,827,"Flooring Service",7,25,175,18,193
1856,828,"Electricity Service",2,49,98,10,108
1857,828,"AC Maintenance Service",9,20,180,18,198
1858,829,"Plumber Service",7,11,77,8,85
1859,829,"Window Cleaning Service",5,41,205,21,226
1860,830,"Electricity Service",6,19,114,11,125
1861,830,"Flooring Service",3,20,60,6,66
1862,831,"Flooring Service",3,28,84,8,92
1863,831,"Gas Service",9,29,261,26,287
1864,832,"Flooring Service",9,45,405,41,446
1865,832,"Flooring Service",4,32,128,13,141
1866,833,"AC Maintenance Service",6,28,168,17,185
1867,833,"AC Maintenance Service",6,37,222,22,244
1868,834,"Gas Service",8,24,192,19,211
1869,834,"Window Cleaning Service",8,15,120,12,132
1870,835,"Electricity Service",8,25,200,20,220
1871,835,"Gas Service",3,12,36,4,40
1872,836,"Plumber Service",7,13,91,9,100
1873,836,"Flooring Service",6,34,204,20,224
1874,837,"Gas Service",2,36,72,7,79
1875,837,"Window Cleaning Service",9,49,441,44,485
1876,838,"Electricity Service",7,21,147,15,162
1877,838,"Flooring Service",7,45,315,32,347
1878,839,"Plumber Service",3,17,51,5,56
1879,839,"Gas Service",8,24,192,19,211
1880,840,"Window Cleaning Service",2,28,56,6,62
1881,840,"Plumber Service",10,44,440,44,484
1882,841,"AC Maintenance Service",7,39,273,27,300
1883,841,"Gas Service",3,19,57,6,63
1884,842,"Flooring Service",1,40,40,4,44
1885,842,"Electricity Service",10,14,140,14,154
1886,843,"Electricity Service",10,10,100,10,110
1887,843,"Window Cleaning Service",4,25,100,10,110
1888,844,"Gas Service",1,32,32,3,35
1889,844,"Plumber Service",6,39,234,23,257
1890,845,"Electricity Service",6,21,126,13,139
1891,845,"Electricity Service",5,20,100,10,110
1892,846,"Electricity Service",10,21,210,21,231
1893,846,"Gas Service",6,12,72,7,79
1894,847,"Plumber Service",10,27,270,27,297
1895,847,"Electricity Service",4,39,156,16,172
1896,848,"Plumber Service",10,14,140,14,154
1897,848,"Electricity Service",8,47,376,38,414
1898,849,"Window Cleaning Service",1,47,47,5,52
1899,849,"Electricity Service",10,50,500,50,550
1900,850,"Window Cleaning Service",3,15,45,5,50
1901,850,"Electricity Service",7,22,154,15,169
1902,851,"Gas Service",2,45,90,9,99
1903,851,"Electricity Service",9,38,342,34,376
1904,852,"Plumber Service",8,20,160,16,176
1905,852,"Plumber Service",3,18,54,5,59
1906,853,"Flooring Service",5,44,220,22,242
1907,853,"Gas Service",8,27,216,22,238
1908,854,"Window Cleaning Service",2,20,40,4,44
1909,854,"Plumber Service",8,43,344,34,378
1910,855,"Flooring Service",9,40,360,36,396
1911,855,"Window Cleaning Service",5,24,120,12,132
1912,856,"Flooring Service",7,39,273,27,300
1913,856,"Plumber Service",10,42,420,42,462
1914,857,"Gas Service",3,22,66,7,73
1915,857,"Plumber Service",7,38,266,27,293
1916,858,"AC Maintenance Service",5,38,190,19,209
1917,858,"Flooring Service",4,49,196,20,216
1918,859,"Gas Service",3,30,90,9,99
1919,859,"Window Cleaning Service",3,22,66,7,73
1920,860,"AC Maintenance Service",9,15,135,14,149
1921,860,"AC Maintenance Service",8,32,256,26,282
1922,861,"Gas Service",8,42,336,34,370
1923,861,"Gas Service",1,27,27,3,30
1924,862,"Electricity Service",3,27,81,8,89
1925,862,"Window Cleaning Service",1,16,16,2,18
1926,863,"Electricity Service",10,42,420,42,462
1927,863,"Electricity Service",3,25,75,8,83
1928,864,"Gas Service",5,17,85,9,94
1929,864,"Gas Service",9,22,198,20,218
1930,865,"Plumber Service",3,14,42,4,46
1931,865,"Window Cleaning Service",9,46,414,41,455
1932,866,"Flooring Service",4,42,168,17,185
1933,866,"Plumber Service",2,18,36,4,40
1934,867,"Electricity Service",6,36,216,22,238
1935,867,"Electricity Service",3,29,87,9,96
1936,868,"Gas Service",1,41,41,4,45
1937,868,"Electricity Service",8,34,272,27,299
1938,869,"Flooring Service",10,39,390,39,429
1939,869,"Gas Service",6,44,264,26,290
1940,870,"Window Cleaning Service",6,47,282,28,310
1941,870,"Flooring Service",1,41,41,4,45
1942,871,"Plumber Service",3,36,108,11,119
1943,871,"Gas Service",1,23,23,2,25
1944,872,"Flooring Service",3,24,72,7,79
1945,872,"AC Maintenance Service",10,34,340,34,374
1946,873,"Window Cleaning Service",1,38,38,4,42
1947,873,"Electricity Service",4,27,108,11,119
1948,874,"Plumber Service",2,47,94,9,103
1949,874,"Plumber Service",9,19,171,17,188
1950,875,"Flooring Service",3,43,129,13,142
1951,875,"Gas Service",9,38,342,34,376
1952,876,"Flooring Service",9,25,225,23,248
1953,876,"Electricity Service",10,44,440,44,484
1954,877,"Flooring Service",1,29,29,3,32
1955,877,"AC Maintenance Service",3,50,150,15,165
1956,878,"Plumber Service",2,28,56,6,62
1957,878,"Gas Service",1,21,21,2,23
1958,879,"AC Maintenance Service",2,50,100,10,110
1959,879,"Flooring Service",7,10,70,7,77
1960,880,"Plumber Service",10,24,240,24,264
1961,880,"Plumber Service",10,18,180,18,198
1962,881,"Plumber Service",9,31,279,28,307
1963,881,"Gas Service",1,43,43,4,47
1964,882,"Electricity Service",9,41,369,37,406
1965,882,"AC Maintenance Service",1,27,27,3,30
1966,883,"Window Cleaning Service",3,27,81,8,89
1967,883,"AC Maintenance Service",7,19,133,13,146
1968,884,"Flooring Service",3,24,72,7,79
1969,884,"Window Cleaning Service",2,14,28,3,31
1970,885,"Electricity Service",7,42,294,29,323
1971,885,"Gas Service",10,47,470,47,517
1972,886,"AC Maintenance Service",2,32,64,6,70
1973,886,"Flooring Service",1,20,20,2,22
1974,887,"Gas Service",4,41,164,16,180
1975,887,"Window Cleaning Service",9,46,414,41,455
1976,888,"Window Cleaning Service",8,33,264,26,290
1977,888,"Window Cleaning Service",7,43,301,30,331
1978,889,"Plumber Service",3,46,138,14,152
1979,889,"Gas Service",5,25,125,13,138
1980,890,"Flooring Service",2,26,52,5,57
1981,890,"Electricity Service",8,23,184,18,202
1982,891,"Plumber Service",3,34,102,10,112
1983,891,"AC Maintenance Service",4,35,140,14,154
1984,892,"AC Maintenance Service",6,27,162,16,178
1985,892,"Gas Service",8,29,232,23,255
1986,893,"Flooring Service",5,21,105,11,116
1987,893,"Plumber Service",5,41,205,21,226
1988,894,"Flooring Service",7,40,280,28,308
1989,894,"Plumber Service",3,42,126,13,139
1990,895,"Plumber Service",1,30,30,3,33
1991,895,"Window Cleaning Service",9,30,270,27,297
1992,896,"Window Cleaning Service",8,35,280,28,308
1993,896,"Plumber Service",7,16,112,11,123
1994,897,"Flooring Service",4,49,196,20,216
1995,897,"Plumber Service",4,35,140,14,154
1996,898,"AC Maintenance Service",2,31,62,6,68
1997,898,"Window Cleaning Service",2,21,42,4,46
1998,899,"Electricity Service",5,11,55,6,61
1999,899,"Window Cleaning Service",7,14,98,10,108
2000,900,"Gas Service",3,25,75,8,83
2001,900,"Electricity Service",2,29,58,6,64
2002,901,"Electricity Service",1,31,31,3,34
2003,901,"Electricity Service",7,21,147,15,162
2004,902,"Flooring Service",9,22,198,20,218
2005,902,"Plumber Service",7,10,70,7,77
2006,903,"AC Maintenance Service",10,24,240,24,264
2007,903,"Flooring Service",3,49,147,15,162
2008,904,"Flooring Service",2,28,56,6,62
2009,904,"Electricity Service",5,18,90,9,99
2010,905,"Flooring Service",9,35,315,32,347
2011,905,"AC Maintenance Service",3,16,48,5,53
2012,906,"AC Maintenance Service",7,48,336,34,370
2013,906,"Plumber Service",1,26,26,3,29
2014,907,"Flooring Service",5,26,130,13,143
2015,907,"Electricity Service",9,38,342,34,376
2016,908,"Gas Service",3,41,123,12,135
2017,908,"Gas Service",1,27,27,3,30
2018,909,"AC Maintenance Service",5,46,230,23,253
2019,909,"Flooring Service",8,38,304,30,334
2020,910,"Gas Service",7,26,182,18,200
2021,910,"Window Cleaning Service",4,47,188,19,207
2022,911,"Gas Service",3,15,45,5,50
2023,911,"AC Maintenance Service",6,46,276,28,304
2024,912,"Window Cleaning Service",10,36,360,36,396
2025,912,"Plumber Service",9,29,261,26,287
2026,913,"Flooring Service",10,48,480,48,528
2027,913,"Electricity Service",4,29,116,12,128
2028,914,"Flooring Service",4,12,48,5,53
2029,914,"Electricity Service",3,15,45,5,50
2030,915,"Window Cleaning Service",4,43,172,17,189
2031,915,"Flooring Service",10,50,500,50,550
2032,916,"Flooring Service",5,13,65,7,72
2033,916,"Gas Service",1,41,41,4,45
2034,917,"Flooring Service",9,12,108,11,119
2035,917,"AC Maintenance Service",7,32,224,22,246
2036,918,"Window Cleaning Service",5,22,110,11,121
2037,918,"Plumber Service",4,28,112,11,123
2038,919,"Gas Service",10,47,470,47,517
2039,919,"Flooring Service",4,26,104,10,114
2040,920,"Gas Service",10,48,480,48,528
2041,920,"Flooring Service",2,26,52,5,57
2042,921,"Window Cleaning Service",9,22,198,20,218
2043,921,"Gas Service",5,27,135,14,149
2044,922,"Window Cleaning Service",9,32,288,29,317
2045,922,"Gas Service",6,31,186,19,205
2046,923,"Window Cleaning Service",7,34,238,24,262
2047,923,"AC Maintenance Service",6,27,162,16,178
2048,924,"Plumber Service",9,44,396,40,436
2049,924,"AC Maintenance Service",9,30,270,27,297
2050,925,"Window Cleaning Service",3,48,144,14,158
2051,925,"Window Cleaning Service",4,39,156,16,172
2052,926,"Plumber Service",7,33,231,23,254
2053,926,"Plumber Service",1,21,21,2,23
2054,927,"Flooring Service",2,39,78,8,86
2055,927,"Plumber Service",8,21,168,17,185
2056,928,"AC Maintenance Service",10,45,450,45,495
2057,928,"Flooring Service",7,27,189,19,208
2058,929,"AC Maintenance Service",5,37,185,19,204
2059,929,"Electricity Service",5,12,60,6,66
2060,930,"Flooring Service",10,12,120,12,132
2061,930,"Flooring Service",2,24,48,5,53
2062,931,"Window Cleaning Service",10,46,460,46,506
2063,931,"AC Maintenance Service",2,40,80,8,88
2064,932,"Flooring Service",4,48,192,19,211
2065,932,"Plumber Service",2,18,36,4,40
2066,933,"Window Cleaning Service",2,21,42,4,46
2067,933,"Gas Service",9,16,144,14,158
2068,934,"Electricity Service",5,44,220,22,242
2069,934,"Gas Service",10,47,470,47,517
2070,935,"AC Maintenance Service",1,23,23,2,25
2071,935,"Electricity Service",3,41,123,12,135
2072,936,"Plumber Service",6,31,186,19,205
2073,936,"Plumber Service",4,34,136,14,150
2074,937,"Window Cleaning Service",3,50,150,15,165
2075,937,"Flooring Service",6,25,150,15,165
2076,938,"Gas Service",10,33,330,33,363
2077,938,"Gas Service",9,43,387,39,426
2078,939,"Window Cleaning Service",4,10,40,4,44
2079,939,"Electricity Service",2,30,60,6,66
2080,940,"Plumber Service",9,19,171,17,188
2081,940,"Flooring Service",5,36,180,18,198
2082,941,"Plumber Service",6,23,138,14,152
2083,941,"Window Cleaning Service",6,23,138,14,152
2084,942,"Electricity Service",8,46,368,37,405
2085,942,"Electricity Service",8,42,336,34,370
2086,943,"Gas Service",7,31,217,22,239
2087,943,"Flooring Service",3,34,102,10,112
2088,944,"Flooring Service",10,10,100,10,110
2089,944,"Gas Service",6,18,108,11,119
2090,945,"AC Maintenance Service",9,17,153,15,168
2091,945,"Flooring Service",1,40,40,4,44
2092,946,"Plumber Service",3,33,99,10,109
2093,946,"Plumber Service",10,44,440,44,484
2094,947,"AC Maintenance Service",3,32,96,10,106
2095,947,"Plumber Service",2,18,36,4,40
2096,948,"Flooring Service",6,23,138,14,152
2097,948,"Window Cleaning Service",9,39,351,35,386
2098,949,"Gas Service",9,49,441,44,485
2099,949,"Plumber Service",10,19,190,19,209
2100,950,"Flooring Service",3,18,54,5,59
2101,950,"Window Cleaning Service",8,32,256,26,282
2102,951,"Gas Service",3,35,105,11,116
2103,951,"Window Cleaning Service",5,41,205,21,226
2104,952,"Electricity Service",1,11,11,1,12
2105,952,"AC Maintenance Service",4,12,48,5,53
2106,953,"Window Cleaning Service",3,43,129,13,142
2107,953,"Window Cleaning Service",2,14,28,3,31
2108,954,"AC Maintenance Service",6,14,84,8,92
2109,954,"Flooring Service",3,10,30,3,33
2110,955,"Gas Service",9,49,441,44,485
2111,955,"Window Cleaning Service",8,17,136,14,150
2112,956,"Gas Service",2,19,38,4,42
2113,956,"Window Cleaning Service",10,32,320,32,352
2114,957,"Window Cleaning Service",3,16,48,5,53
2115,957,"Plumber Service",10,18,180,18,198
2116,958,"Gas Service",10,39,390,39,429
2117,958,"Plumber Service",7,28,196,20,216
2118,959,"Gas Service",8,42,336,34,370
2119,959,"Flooring Service",2,30,60,6,66
2120,960,"Window Cleaning Service",6,43,258,26,284
2121,960,"Gas Service",9,21,189,19,208
2122,961,"Electricity Service",6,35,210,21,231
2123,961,"Plumber Service",8,21,168,17,185
2124,962,"Gas Service",7,20,140,14,154
2125,962,"Gas Service",8,37,296,30,326
2126,963,"AC Maintenance Service",9,21,189,19,208
2127,963,"Flooring Service",2,18,36,4,40
2128,964,"Plumber Service",8,20,160,16,176
2129,964,"Gas Service",7,45,315,32,347
2130,965,"Gas Service",6,29,174,17,191
2131,965,"Electricity Service",7,16,112,11,123
2132,966,"Electricity Service",9,15,135,14,149
2133,966,"Electricity Service",5,44,220,22,242
2134,967,"Gas Service",1,43,43,4,47
2135,967,"Flooring Service",6,44,264,26,290
2136,968,"Plumber Service",9,46,414,41,455
2137,968,"Window Cleaning Service",4,35,140,14,154
2138,969,"Electricity Service",1,23,23,2,25
2139,969,"AC Maintenance Service",8,27,216,22,238
2140,970,"Plumber Service",7,27,189,19,208
2141,970,"Gas Service",9,21,189,19,208
2142,971,"Plumber Service",3,10,30,3,33
2143,971,"Flooring Service",3,21,63,6,69
2144,972,"Plumber Service",3,12,36,4,40
2145,972,"Window Cleaning Service",8,26,208,21,229
2146,973,"AC Maintenance Service",9,20,180,18,198
2147,973,"Window Cleaning Service",1,16,16,2,18
2148,974,"Plumber Service",7,50,350,35,385
2149,974,"Flooring Service",5,10,50,5,55
2150,975,"Gas Service",6,25,150,15,165
2151,975,"AC Maintenance Service",3,17,51,5,56
2152,976,"Gas Service",10,47,470,47,517
2153,976,"Plumber Service",3,25,75,8,83
2154,977,"AC Maintenance Service",4,42,168,17,185
2155,977,"Gas Service",10,46,460,46,506
2156,978,"Electricity Service",7,25,175,18,193
2157,978,"AC Maintenance Service",9,24,216,22,238
2158,979,"Window Cleaning Service",3,47,141,14,155
2159,979,"Electricity Service",10,42,420,42,462
2160,980,"Electricity Service",7,12,84,8,92
2161,980,"Electricity Service",4,21,84,8,92
2162,981,"Flooring Service",3,20,60,6,66
2163,981,"Electricity Service",3,22,66,7,73
2164,982,"Electricity Service",6,35,210,21,231
2165,982,"Gas Service",9,17,153,15,168
2166,983,"AC Maintenance Service",1,45,45,5,50
2167,983,"Electricity Service",4,35,140,14,154
2168,984,"Plumber Service",9,40,360,36,396
2169,984,"Flooring Service",9,10,90,9,99
2170,985,"Gas Service",1,24,24,2,26
2171,985,"Gas Service",7,19,133,13,146
2172,986,"Window Cleaning Service",3,28,84,8,92
2173,986,"Electricity Service",3,10,30,3,33
2174,987,"Gas Service",7,48,336,34,370
2175,987,"Window Cleaning Service",6,28,168,17,185
2176,988,"Flooring Service",9,44,396,40,436
2177,988,"Window Cleaning Service",2,19,38,4,42
2178,989,"Flooring Service",8,22,176,18,194
2179,989,"Window Cleaning Service",8,11,88,9,97
2180,990,"Plumber Service",10,32,320,32,352
2181,990,"Electricity Service",9,21,189,19,208
2182,991,"Plumber Service",7,41,287,29,316
2183,991,"Flooring Service",6,45,270,27,297
2184,992,"Plumber Service",7,10,70,7,77
2185,992,"Window Cleaning Service",1,34,34,3,37
2186,993,"Electricity Service",2,14,28,3,31
2187,993,"Plumber Service",7,35,245,25,270
2188,994,"Gas Service",3,33,99,10,109
2189,994,"Flooring Service",5,14,70,7,77
2190,995,"Electricity Service",3,48,144,14,158
2191,995,"Flooring Service",3,12,36,4,40
2192,996,"Window Cleaning Service",2,24,48,5,53
2193,996,"Gas Service",9,26,234,23,257
2194,997,"Gas Service",8,47,376,38,414
2195,997,"Gas Service",8,40,320,32,352
2196,998,"AC Maintenance Service",5,24,120,12,132
2197,998,"Plumber Service",8,33,264,26,290
2198,999,"Plumber Service",4,36,144,14,158
2199,999,"Gas Service",4,11,44,4,48
2200,1000,"Plumber Service",8,11,88,9,97
2201,1000,"Window Cleaning Service",9,18,162,16,178
